store_name,order,order_fin,order_cancel,order_delivery,order_takeout,order_weekday,order_weekend,order_time_11,order_time_12,order_time_13,order_time_14,order_time_15,order_time_16,order_time_17,order_time_18,order_time_19,order_time_20,order_time_21,delta_avg,year_month
가덕해안로점,1000,818,182,741,259,732,268,78,118,84,99,66,77,107,91,100,86,94,33.9437652811736,202004
가마산로2점,1470,1207,263,1099,371,1076,394,181,141,128,112,123,146,132,143,118,121,125,34.70256835128418,202004
가마산로점,1021,838,183,792,229,748,273,81,105,101,94,93,111,77,81,104,88,86,34.730310262529834,202004
감천항로점,1005,808,197,716,289,739,266,88,91,100,86,99,84,85,91,83,101,97,34.29579207920792,202004
강남대로2점,1098,886,212,796,302,805,293,114,103,87,93,110,98,105,101,83,101,103,35.10158013544018,202004
강남대로점,1061,855,206,784,277,776,285,96,100,87,99,96,84,115,108,95,92,89,34.12865497076023,202004
강남점3점,1272,1037,235,919,353,932,340,98,125,122,120,110,126,111,129,116,97,118,34.69913211186114,202004
경열로점,1151,941,210,871,280,844,307,107,98,122,109,100,103,112,103,106,102,89,34.99256110520723,202004
계룡로점,1381,1126,255,1022,359,1013,368,121,118,140,125,142,128,121,118,138,112,118,34.714031971580816,202004
계족로점,1145,946,199,855,290,840,305,112,97,93,83,116,105,88,115,109,113,114,34.151162790697676,202004
고산자로2점,1379,1145,234,1018,361,1012,367,117,121,129,136,119,148,115,131,121,135,107,34.327510917030565,202004
고산자로점,1030,835,195,750,280,757,273,95,97,101,75,88,99,86,100,102,90,97,35.24910179640719,202004
관악로2점,1406,1139,267,1036,370,1031,375,131,121,127,119,127,153,128,124,133,120,123,35.12379280070237,202004
관악로점,1123,926,197,834,289,824,299,96,74,107,110,111,128,108,108,82,105,94,34.06911447084233,202004
관저동로점,1439,1210,229,1054,385,1056,383,122,115,150,142,122,128,135,131,136,137,121,34.57685950413223,202004
광산로점,972,801,171,699,273,714,258,86,102,72,97,106,82,67,90,95,95,80,34.67790262172284,202004
광주여대길점,1205,981,224,912,293,883,322,117,127,93,104,111,92,120,108,116,110,107,33.984709480122326,202004
구덕로점,1182,968,214,873,309,869,313,109,98,96,121,90,123,106,121,108,98,112,48.538223140495866,202004
구청로점,880,728,152,641,239,642,238,74,87,94,90,78,77,74,79,76,65,86,34.46291208791209,202004
국제금융로2점,739,609,130,522,217,540,199,60,61,68,71,66,66,62,61,56,87,81,47.67159277504105,202004
국제금융로점,1355,1096,259,1002,353,992,363,123,119,138,126,130,122,133,119,116,114,115,34.39142335766423,202004
금송로점,1260,1045,215,939,321,923,337,127,110,112,109,105,138,127,99,95,124,114,34.361722488038275,202004
금화로점,1293,1047,246,952,341,948,345,104,114,134,123,125,114,112,109,130,115,113,34.75358166189112,202004
기장대로점,1438,1194,244,1086,352,1054,384,122,129,134,136,141,112,135,116,128,127,158,34.31574539363484,202004
기흥점,1061,875,186,799,262,779,282,75,105,89,97,110,102,84,103,100,102,94,34.098285714285716,202004
낙동대로2점,1449,1161,288,1058,391,1059,390,147,133,127,131,129,112,150,136,137,118,129,34.20413436692507,202004
낙동대로점,1209,984,225,889,320,888,321,111,110,122,100,115,122,122,92,95,109,111,33.80691056910569,202004
낙동북로점,1119,917,202,819,300,820,299,100,105,90,104,122,89,99,94,107,115,94,34.412213740458014,202004
남동남로점,1342,1085,257,964,378,984,358,124,113,136,115,137,103,137,125,113,126,113,33.88110599078341,202004
남부순환로2점,1507,1215,292,1091,416,1106,401,130,141,156,137,153,153,140,144,134,111,108,34.81481481481482,202004
남부순환로점,1208,981,227,885,323,885,323,141,107,103,97,115,106,109,97,105,112,116,34.5677879714577,202004
남천동로점,964,784,180,698,266,708,256,94,94,84,89,87,76,84,88,85,97,86,34.75,202004
내방로점,1324,1081,243,972,352,973,351,123,132,116,103,119,117,115,128,114,119,138,20.270120259019425,202004
노해로2점,1625,1325,300,1214,411,1195,430,141,151,154,135,134,169,139,148,158,159,137,35.27698113207547,202004
노해로점,1177,958,219,875,302,861,316,107,108,94,119,108,99,100,106,117,110,109,34.97390396659708,202004
녹사평대로2점,1529,1262,267,1118,411,1124,405,135,132,154,159,120,134,128,143,140,123,161,34.61331220285261,202004
녹사평대로점,1342,1082,260,989,353,984,358,135,112,113,125,121,124,114,112,112,151,123,34.36968576709797,202004
다대동로점,1403,1142,261,1052,351,1026,377,134,113,118,111,135,126,143,134,136,123,130,34.68213660245184,202004
달맞이길점,1332,1072,260,988,344,978,354,118,107,125,119,110,132,125,118,115,140,123,34.646455223880594,202004
당산로2점,1356,1100,256,1013,343,993,363,144,123,120,122,119,111,120,137,121,116,123,34.474545454545456,202004
당산로점,1058,868,190,781,277,778,280,94,98,91,92,103,91,96,100,97,87,109,48.47811059907834,202004
대둔산로점,1444,1187,257,1064,380,1056,388,117,135,119,143,146,120,152,141,144,119,108,34.192080876158386,202004
대전로점,1157,923,234,852,305,846,311,92,120,100,117,107,121,104,89,99,100,108,48.48645720476706,202004
대종로점,1466,1206,260,1115,351,1071,395,149,141,133,129,111,120,136,133,123,155,136,34.927031509121065,202004
대흥로점,818,662,156,604,214,600,218,72,84,80,69,70,72,73,77,65,78,78,33.646525679758305,202004
덕남길점,1298,1044,254,951,347,950,348,107,124,114,118,105,121,127,140,115,98,129,34.00383141762452,202004
덕수궁길2점,1183,965,218,855,328,868,315,115,107,111,111,122,105,104,115,92,95,106,34.00310880829016,202004
덕수궁길점,995,804,191,748,247,735,260,84,81,84,102,98,93,83,103,94,79,94,33.96268656716418,202004
도봉로2점,935,742,193,686,249,688,247,76,86,77,84,93,78,77,105,80,98,81,46.588948787061994,202004
도봉로점,1271,1039,232,945,326,929,342,128,126,112,98,131,115,95,114,112,123,117,34.460057747834455,202004
동구청로점,1305,1067,238,969,336,956,349,101,103,119,113,127,111,119,139,120,127,126,34.058106841611995,202004
둔산로점,1083,868,215,802,281,794,289,102,85,81,99,105,104,97,111,104,98,97,20.169354838709676,202004
둔산서로점,1153,918,235,867,286,846,307,105,112,96,106,120,108,101,121,96,98,90,34.10021786492375,202004
둔산중로점,1088,911,177,813,275,800,288,82,87,107,98,95,99,96,85,100,119,120,34.33260153677278,202004
르노삼성대로점,1060,880,180,773,287,777,283,94,86,97,107,94,94,110,93,90,96,99,35.26704545454545,202004
마들로2점,1021,837,184,749,272,750,271,83,86,99,85,103,86,104,81,98,87,109,35.112305854241335,202004
마들로점,1443,1207,236,1055,388,1059,384,125,115,135,130,134,124,144,138,127,142,129,34.57829328914664,202004
마린시티1로점,910,753,157,680,230,666,244,78,88,84,85,89,89,71,95,72,87,72,33.61885790172643,202004
마포대로2점,1318,1066,252,983,335,969,349,126,94,117,121,140,115,136,108,125,135,101,34.029080675422136,202004
마포대로점,1379,1099,280,1000,379,1011,368,125,129,111,139,106,127,134,112,119,146,131,34.7761601455869,202004
망양로점,1325,1094,231,980,345,974,351,132,137,114,108,125,117,131,117,124,105,115,35.145338208409505,202004
명지국제7로점,1146,920,226,851,295,842,304,113,112,89,98,110,96,108,98,106,126,90,34.39891304347826,202004
명지동점,1265,1032,233,914,351,928,337,123,115,103,122,97,123,131,91,110,124,126,34.531976744186046,202004
명지새동네길점,1146,917,229,879,267,841,305,109,99,85,113,107,129,94,99,101,108,102,33.906215921483096,202004
목공동로2점,1447,1179,268,1047,400,1067,380,138,135,135,136,138,133,133,108,122,134,135,34.17133163698049,202004
목공동로점,1148,925,223,862,286,842,306,107,101,114,128,111,110,88,86,101,115,87,47.052972972972974,202004
못골로점,1088,883,205,804,284,796,292,94,100,99,110,113,102,103,95,102,84,86,34.257078142695356,202004
무교로2점,1523,1250,273,1126,397,1113,410,147,137,143,123,149,154,120,113,151,137,149,34.0904,202004
무교로점,852,672,180,627,225,625,227,62,71,86,83,78,68,78,80,90,60,96,35.208333333333336,202004
문예회관길점,1173,970,203,846,327,859,314,111,123,112,107,100,100,115,97,97,116,95,20.349484536082475,202004
민락수변로점,1269,1044,225,949,320,930,339,116,89,119,96,106,113,118,124,132,143,113,34.87547892720306,202004
방죽로점,1214,1011,203,888,326,893,321,121,104,101,110,114,97,139,121,110,96,101,33.97131552917903,202004
배재로점,1468,1162,306,1095,373,1076,392,145,119,145,148,144,141,106,132,144,129,115,34.924268502581754,202004
법원로2점,1295,1057,238,971,324,951,344,119,111,114,128,119,128,109,108,129,114,116,34.93282876064333,202004
법원로점,2227,1826,401,1659,568,1635,592,167,250,189,197,206,206,230,206,196,186,194,33.947426067908,202004
보문로2점,1059,847,212,761,298,777,282,96,93,99,99,97,92,95,96,105,94,93,34.59504132231405,202004
보문로점,1141,976,165,858,283,834,307,103,108,118,86,116,103,101,99,89,107,111,34.967213114754095,202004
복수서로점,879,723,156,651,228,646,233,84,75,73,92,101,72,83,67,82,72,78,34.46334716459198,202004
봉선로점,1138,940,198,843,295,832,306,103,107,93,92,123,107,111,110,97,92,103,34.34148936170213,202004
봉화산로2점,964,777,187,685,279,706,258,77,107,82,87,97,91,69,80,92,86,96,34.63706563706564,202004
봉화산로점,792,657,135,603,189,579,213,63,76,69,78,77,68,70,89,70,65,67,35.62252663622527,202004
부흥로점,1321,1100,221,989,332,971,350,110,118,105,127,131,115,131,105,126,125,128,35.22727272727273,202004
북유성대로점,1262,1031,231,940,322,928,334,104,121,113,108,104,100,126,116,109,124,137,34.97866149369544,202004
분포로점,1495,1211,284,1130,365,1100,395,136,144,141,126,114,138,164,138,130,131,133,34.70933113129645,202004
비아로점,1510,1207,303,1122,388,1110,400,126,118,133,139,134,138,135,150,150,148,139,34.14581607290803,202004
사우중로점,1590,1311,279,1186,404,1166,424,136,141,143,149,154,139,142,142,158,137,149,34.56140350877193,202004
사직로2점,1003,815,188,728,275,736,267,96,82,97,94,83,104,77,72,101,101,96,34.67361963190184,202004
사직로점,2261,1853,408,1657,604,1658,603,237,182,190,211,205,197,207,212,201,215,204,34.539125742039936,202004
삼봉로2점,1326,1066,260,971,355,974,352,128,112,114,129,121,100,131,125,124,124,118,34.626641651031896,202004
삼봉로점,1006,823,183,719,287,738,268,102,107,85,85,87,82,88,104,80,88,98,34.64884568651276,202004
삼일대로2점,967,792,175,701,266,711,256,83,94,93,84,79,88,86,79,93,104,84,34.82954545454545,202004
삼일대로점,1179,955,224,867,312,866,313,105,108,128,103,106,100,106,120,92,113,98,33.334031413612564,202004
상무공원로점,1375,1106,269,1002,373,1012,363,124,115,115,120,122,133,129,124,126,127,140,34.60307414104882,202004
상무대로점,1085,884,201,802,283,796,289,97,85,90,96,117,104,106,104,92,94,100,34.571266968325794,202004
상무번영로점,886,729,157,662,224,647,239,82,86,76,86,91,60,67,89,91,80,78,48.08230452674897,202004
서남로점,1084,896,188,791,293,792,292,95,108,101,94,89,93,92,102,107,88,115,33.526785714285715,202004
서소문로2점,1004,826,178,745,259,737,267,76,101,78,98,91,103,94,91,97,87,88,34.77360774818402,202004
서소문로점,1238,1009,229,902,336,910,328,118,107,118,108,106,132,109,107,115,96,122,35.10604558969276,202004
서초중앙로2점,1207,978,229,909,298,884,323,118,106,120,111,113,109,93,103,108,110,116,34.47239263803681,202004
서초중앙로3점,1055,856,199,778,277,778,277,87,82,99,98,91,93,107,101,98,98,101,34.197429906542055,202004
서초중앙로점,1114,925,189,812,302,818,296,99,98,101,93,98,90,114,128,94,93,106,34.648648648648646,202004
서하로점,1502,1224,278,1106,396,1102,400,124,132,150,136,144,135,130,120,146,134,151,35.27124183006536,202004
석봉로점,828,645,183,609,219,607,221,53,83,63,75,87,72,88,72,78,76,81,34.313178294573646,202004
성남대로점,1498,1254,244,1126,372,1096,402,140,132,138,138,141,126,137,135,134,144,133,34.410685805422645,202004
성내로2점,1274,1035,239,932,342,934,340,111,133,131,109,118,92,125,93,138,116,108,34.66280193236715,202004
성내로점,945,771,174,678,267,695,250,65,87,99,75,92,78,88,95,93,85,88,47.447470817120625,202004
성산동2점,1328,1073,255,1007,321,971,357,140,113,117,108,122,116,118,128,123,111,132,34.747437092264676,202004
성산동점,1001,827,174,731,270,734,267,79,75,95,84,79,84,97,104,93,101,110,20.23700120918984,202004
세종대로2점,1026,849,177,727,299,751,275,99,92,106,89,84,98,100,84,97,87,90,34.83510011778563,202004
세종대로점,1147,942,205,844,303,844,303,92,121,115,103,95,111,108,95,110,102,95,33.86518046709129,202004
세종로점,1142,930,212,829,313,840,302,86,106,99,102,111,104,92,113,102,117,110,34.94731182795699,202004
송정공원로점,884,720,164,649,235,648,236,74,77,93,82,79,79,76,72,96,77,79,34.12083333333333,202004
송정해변로점,1530,1247,283,1138,392,1122,408,131,152,126,152,140,140,140,138,138,126,147,20.474739374498796,202004
시흥대로2점,970,795,175,719,251,711,259,86,82,86,108,76,76,95,84,88,100,89,34.918238993710695,202004
시흥대로점,1203,997,206,897,306,878,325,91,108,124,115,115,128,99,110,105,104,104,34.97793380140421,202004
신갈마로점,1146,944,202,831,315,841,305,97,97,97,128,113,103,97,103,105,94,112,34.764830508474574,202004
신일동로점,1328,1088,240,972,356,972,356,85,128,127,126,110,131,122,130,123,112,134,34.333639705882355,202004
신일서로점,1239,1007,232,927,312,908,331,112,114,119,103,89,122,112,125,127,103,113,34.6266137040715,202004
안양천로2점,1118,896,222,823,295,821,297,119,89,91,92,99,111,111,109,104,87,106,34.3359375,202004
안양천로점,1176,960,216,865,311,859,317,96,99,118,108,126,102,101,108,112,105,101,33.651041666666664,202004
양재2점,1268,1027,241,932,336,932,336,121,119,111,101,128,117,114,105,106,136,110,34.524829600778965,202004
양재점,1175,972,203,867,308,863,312,96,105,105,112,117,116,106,110,116,98,94,34.19238683127572,202004
어등대로점,1183,979,204,854,329,869,314,121,105,113,111,107,118,95,109,94,111,99,34.46578140960163,202004
엑스포로점,1088,879,209,791,297,800,288,110,96,100,81,109,91,111,95,97,113,85,34.83276450511946,202004
연제로점,1386,1141,245,1030,356,1016,370,145,128,110,138,125,107,107,125,147,119,135,34.519719544259424,202004
연희로2점,1380,1131,249,1027,353,1011,369,112,122,127,104,111,127,143,143,131,117,143,34.92838196286472,202004
연희로점,1057,846,211,767,290,774,283,104,107,100,124,84,79,113,88,78,78,102,34.93735224586288,202004
영통구점,1058,875,183,785,273,775,283,92,109,86,91,94,109,89,93,97,95,103,34.77028571428571,202004
예술길점,1145,925,220,839,306,840,305,94,117,100,89,107,110,114,111,124,96,83,34.78378378378378,202004
온천천로점,1526,1276,250,1102,424,1123,403,143,127,140,137,153,143,131,132,143,152,125,34.14811912225705,202004
올림픽로2점,1349,1094,255,993,356,989,360,124,112,125,124,125,111,121,127,140,118,122,20.486288848263253,202004
올림픽로점,971,779,192,706,265,709,262,82,81,96,98,81,94,96,94,81,88,80,34.15019255455712,202004
용대로점,1026,843,183,763,263,754,272,93,93,107,97,100,83,88,94,91,95,85,34.11387900355872,202004
용아로점,1323,1079,244,970,353,973,350,133,139,112,123,119,120,98,128,111,115,125,35.13901760889713,202004
용운동점,854,717,137,626,228,625,229,72,73,69,81,81,63,104,74,79,97,61,34.38772663877266,202004
우치로점,1124,909,215,819,305,825,299,111,97,100,98,110,96,88,113,96,102,113,48.88228822882288,202004
월계로2점,1000,804,196,734,266,730,270,95,89,96,96,88,85,91,88,96,86,90,34.646766169154226,202004
월계로점,1205,1006,199,886,319,885,320,114,100,137,101,116,113,109,98,98,109,110,19.777335984095426,202004
월드컵대로2점,882,751,131,651,231,651,231,85,84,79,85,93,58,89,81,84,71,73,34.563249001331556,202004
월드컵대로점,1116,919,197,818,298,817,299,104,104,91,125,73,101,90,117,96,112,103,34.51251360174102,202004
월드컵로2점,1379,1127,252,1026,353,1014,365,109,128,119,99,151,130,149,116,136,124,118,34.25909494232476,202004
월드컵로점,911,740,171,671,240,667,244,73,72,99,83,77,75,87,91,94,87,73,34.18378378378378,202004
은평로2점,845,692,153,639,206,616,229,63,85,81,76,84,88,66,86,60,64,92,35.27312138728324,202004
은평로점,1214,980,234,875,339,890,324,99,124,109,114,109,125,107,111,114,105,97,34.87244897959184,202004
일산동구점,1119,936,183,841,278,819,300,102,114,103,98,110,107,104,100,87,100,94,34.455128205128204,202004
자양로2점,1061,848,213,785,276,778,283,84,104,95,108,98,94,97,93,87,98,103,34.630896226415096,202004
자양로점,1146,950,196,845,301,842,304,112,122,96,103,79,103,103,104,113,90,121,33.54105263157895,202004
장대로점,1208,981,227,893,315,888,320,111,130,95,109,105,122,110,106,97,106,117,34.61467889908257,202004
장동로점,971,803,168,744,227,716,255,95,107,76,101,81,86,104,80,84,81,76,33.143212951432126,202004
장승배기로2점,1154,956,198,857,297,846,308,104,107,100,127,99,96,103,103,108,108,99,34.46025104602511,202004
장승배기로점,1114,921,193,835,279,814,300,107,95,92,98,90,112,108,81,111,118,102,20.86102062975027,202004
재반로점,1202,995,207,903,299,880,322,110,96,116,111,99,112,115,109,129,106,99,34.34572864321608,202004
절영로점,1442,1159,283,1070,372,1059,383,130,137,116,155,150,102,127,128,122,140,135,34.50388265746333,202004
절재로점,1352,1135,217,1016,336,992,360,131,103,116,120,117,114,122,141,147,127,114,34.74977973568282,202004
제중로점,1152,933,219,865,287,847,305,97,102,112,96,107,118,117,91,106,108,98,34.38906752411575,202004
조치원점,1154,968,186,837,317,849,305,118,106,112,94,97,95,112,100,97,110,113,35.017561983471076,202004
종로2점,1503,1245,258,1122,381,1104,399,147,112,139,141,143,142,144,133,128,145,129,34.42730923694779,202004
종로점,1053,874,179,813,240,773,280,86,82,79,90,87,104,108,115,106,93,103,35.81006864988559,202004
준법로점,1112,888,224,807,305,815,297,107,89,114,104,111,95,96,101,96,107,92,33.806306306306304,202004
중구로점,1443,1182,261,1084,359,1060,383,143,143,130,129,136,110,139,119,120,148,126,34.22419627749577,202004
중동2로점,706,568,138,528,178,517,189,71,62,57,61,71,51,62,76,68,59,68,34.482394366197184,202004
중앙대로2점,1352,1096,256,1001,351,990,362,112,119,138,122,123,99,119,122,127,133,138,33.85948905109489,202004
중앙대로점,2184,1806,378,1621,563,1599,585,204,206,174,192,216,245,184,190,205,183,185,34.604651162790695,202004
증심사길점,1264,1020,244,951,313,929,335,103,118,102,101,133,117,94,137,135,103,121,34.68333333333333,202004
창경궁로2점,1411,1132,279,1028,383,1036,375,134,144,127,105,147,122,121,136,133,135,107,34.390459363957596,202004
창경궁로점,1235,992,243,905,330,906,329,110,92,98,115,112,104,136,128,97,123,120,34.66431451612903,202004
처인구점,993,800,193,767,226,727,266,85,102,97,96,66,83,95,86,95,98,90,34.175,202004
천호대로2점,1535,1279,256,1144,391,1125,410,142,154,144,126,141,137,146,142,132,127,144,33.70602032838155,202004
천호대로점,965,792,173,705,260,707,258,77,73,89,91,93,103,103,80,88,88,80,35.10858585858586,202004
첨단과기로점,1293,1051,242,946,347,947,346,127,117,127,112,106,136,124,123,118,94,109,34.17031398667935,202004
청계청로2점,1328,1062,266,981,347,973,355,110,125,112,129,116,130,121,117,134,127,107,34.58286252354049,202004
청계청로점,879,709,170,641,238,643,236,64,86,81,85,89,80,86,86,67,75,80,34.538787023977434,202004
청사포로점,1233,1015,218,937,296,903,330,100,115,101,121,90,118,120,123,123,105,117,19.81576354679803,202004
태종로점,1151,927,224,841,310,846,305,107,116,111,108,104,96,103,110,95,95,106,33.92125134843582,202004
필문대로점,1148,955,193,839,309,842,306,124,88,117,86,98,115,115,98,126,88,93,35.09005235602094,202004
하남산단점,997,799,198,736,261,729,268,87,83,81,102,91,99,87,95,77,101,94,34.28160200250313,202004
하리해안길점,1106,898,208,841,265,810,296,103,97,86,91,105,132,98,108,84,96,106,34.26057906458797,202004
하신번영로점,1473,1210,263,1077,396,1080,393,126,140,123,141,136,151,119,128,123,146,140,34.15785123966942,202004
하신중앙로점,1204,954,250,878,326,885,319,111,104,109,98,88,120,92,121,123,110,128,34.75890985324948,202004
학감대로점,1383,1139,244,1024,359,1015,368,107,142,119,125,120,130,119,130,115,150,126,34.51009657594381,202004
학동로2점,1405,1123,282,1050,355,1031,374,143,123,106,137,140,123,120,129,128,119,137,34.41585040071238,202004
학동로점,1379,1149,230,1010,369,1013,366,116,109,120,125,157,142,128,128,105,123,126,34.174934725848566,202004
한남로점,997,812,185,738,259,732,265,99,84,84,98,110,79,105,78,82,105,73,33.96182266009852,202004
한누리대로점,1269,1063,206,941,328,938,331,124,116,105,107,127,109,112,110,101,125,133,34.78551269990593,202004
한밭대로점,1055,858,197,740,315,777,278,101,99,105,78,100,99,90,103,104,97,79,48.8018648018648,202004
해안새벽시장길점,1206,985,221,877,329,886,320,112,110,109,108,97,124,112,116,111,98,109,34.786802030456855,202004
해운대로점,1380,1112,268,1034,346,1013,367,114,117,132,124,125,131,117,143,123,125,129,34.42176258992806,202004
해운대해변로점,1005,811,194,737,268,737,268,91,86,90,93,97,91,111,85,90,92,79,21.02466091245376,202004
화곡로2점,1175,943,232,876,299,865,310,114,105,103,117,106,106,109,102,84,117,112,35.654294803817606,202004
화곡로점,1062,878,184,781,281,778,284,86,102,78,90,102,100,101,93,107,101,102,34.97152619589977,202004
화중로점,1146,950,196,869,277,842,304,115,97,114,96,112,99,98,104,94,112,105,33.76105263157895,202004
효덕로점,1296,1044,252,950,346,949,347,125,116,136,105,111,119,112,108,141,118,105,34.61973180076628,202004
효원로점,792,630,162,583,209,579,213,74,72,77,73,56,76,70,82,67,81,64,33.67301587301587,202004
가덕해안로점,1033,845,188,756,277,700,333,86,96,94,99,78,92,88,98,119,100,83,34.2698224852071,202005
가마산로2점,1528,1252,276,1128,400,1037,491,133,136,138,135,145,147,147,147,120,141,139,35.02396166134185,202005
가마산로점,1066,850,216,795,271,724,342,93,89,105,99,88,102,94,102,91,105,98,34.4635294117647,202005
감천항로점,1036,821,215,773,263,702,334,84,99,91,92,95,109,94,97,98,81,96,33.985383678440925,202005
강남대로2점,1110,885,225,835,275,749,361,103,88,102,108,93,91,101,116,108,88,112,34.15819209039548,202005
강남대로점,1094,890,204,808,286,742,352,94,109,103,96,93,100,110,94,99,106,90,34.17752808988764,202005
강남점3점,1312,1067,245,982,330,888,424,116,124,145,99,108,119,116,120,119,117,129,34.7282099343955,202005
경열로점,1182,969,213,889,293,806,376,108,111,100,116,105,110,90,109,109,114,110,34.78328173374613,202005
계룡로점,1433,1153,280,1070,363,972,461,122,117,148,139,136,122,128,128,127,128,138,35.30615784908933,202005
계족로점,1183,961,222,886,297,802,381,103,117,108,100,103,110,103,112,95,127,105,34.09261186264308,202005
고산자로2점,1421,1172,249,1083,338,963,458,127,126,135,150,117,135,126,129,117,129,130,34.784129692832764,202005
고산자로점,1060,865,195,761,299,716,344,107,93,95,111,87,84,95,103,95,101,89,35.225433526011564,202005
관악로2점,1454,1202,252,1061,393,982,472,146,132,140,128,123,151,120,125,123,148,118,34.86189683860233,202005
관악로점,1160,931,229,883,277,786,374,94,102,131,107,93,109,110,108,101,96,109,34.07518796992481,202005
관저동로점,1489,1233,256,1095,394,1010,479,135,147,102,132,150,159,122,138,134,156,114,34.201135442011356,202005
광산로점,1005,812,193,715,290,682,323,81,82,87,91,94,99,93,98,88,93,99,34.29556650246305,202005
광주여대길점,1242,999,243,898,344,838,404,117,111,103,118,107,121,116,117,125,106,101,33.67767767767768,202005
구덕로점,1208,976,232,887,321,824,384,119,114,106,107,103,100,116,105,97,108,133,47.81147540983606,202005
구청로점,911,772,139,670,241,614,297,100,85,76,77,89,88,70,79,82,92,73,35.52461139896373,202005
국제금융로2점,762,623,139,585,177,513,249,76,67,64,59,66,72,62,74,71,74,77,47.857142857142854,202005
국제금융로점,1392,1115,277,1026,366,942,450,130,126,110,140,115,117,131,122,120,125,156,34.719282511210764,202005
금송로점,1304,1051,253,978,326,881,423,124,113,122,131,129,103,112,109,133,105,123,34.35299714557564,202005
금화로점,1338,1113,225,996,342,905,433,125,138,133,121,120,116,120,120,109,120,116,34.41958670260557,202005
기장대로점,1489,1197,292,1135,354,1009,480,137,134,142,152,128,127,121,128,142,148,130,34.439431913116124,202005
기흥점,1088,878,210,815,273,734,354,95,109,85,106,92,99,99,107,110,75,111,33.81093394077449,202005
낙동대로2점,1485,1236,249,1098,387,1005,480,149,124,139,150,135,120,126,129,126,165,122,33.907766990291265,202005
낙동대로점,1247,1035,212,912,335,847,400,107,113,98,127,123,107,125,110,122,112,103,34.0231884057971,202005
낙동북로점,1148,972,176,863,285,778,370,88,90,110,105,100,118,109,108,105,108,107,34.51543209876543,202005
남동남로점,1389,1150,239,1014,375,941,448,140,133,128,120,127,108,136,122,120,126,129,34.55826086956522,202005
남부순환로2점,1550,1271,279,1116,434,1050,500,95,120,155,158,147,159,129,145,140,164,138,33.45790715971676,202005
남부순환로점,1249,1006,243,893,356,847,402,109,126,121,102,116,107,110,124,105,115,114,34.710735586481114,202005
남천동로점,997,815,182,738,259,674,323,87,93,84,93,87,93,92,94,83,85,106,35.00613496932515,202005
내방로점,1371,1127,244,1028,343,928,443,119,113,126,140,130,116,116,156,100,130,125,20.527950310559007,202005
노해로2점,1669,1375,294,1229,440,1128,541,170,155,151,153,136,147,154,144,176,118,165,34.20218181818182,202005
노해로점,1217,972,245,917,300,825,392,109,97,105,113,123,97,119,106,103,124,121,34.415637860082306,202005
녹사평대로2점,1581,1281,300,1177,404,1075,506,157,151,145,134,148,132,143,150,142,133,146,34.38095238095238,202005
녹사평대로점,1391,1139,252,1027,364,944,447,122,128,141,137,129,124,131,109,109,130,131,34.443371378402105,202005
다대동로점,1457,1188,269,1064,393,990,467,134,138,139,135,152,130,141,128,118,112,130,34.0976430976431,202005
달맞이길점,1363,1098,265,996,367,925,438,121,125,113,112,131,136,124,113,118,141,129,34.20127504553734,202005
당산로2점,1401,1155,246,1024,377,948,453,133,108,117,131,124,137,144,131,131,124,121,34.067532467532466,202005
당산로점,1096,880,216,792,304,747,349,108,93,101,84,103,107,104,109,102,94,91,47.21931818181818,202005
대둔산로점,1490,1203,287,1084,406,1009,481,144,119,133,119,130,130,142,136,137,149,151,35.0498753117207,202005
대전로점,1179,967,212,880,299,800,379,113,112,88,96,96,119,107,110,116,103,119,47.77559462254395,202005
대종로점,1522,1254,268,1173,349,1028,494,154,118,138,134,132,135,130,117,155,148,161,35.30701754385965,202005
대흥로점,839,672,167,614,225,570,269,70,64,72,73,88,76,64,74,82,85,91,34.482142857142854,202005
덕남길점,1336,1101,235,1028,308,905,431,125,126,128,124,108,106,125,112,132,118,132,34.009990917347864,202005
덕수궁길2점,1205,987,218,885,320,815,390,103,120,95,108,112,117,115,94,115,109,117,34.657548125633234,202005
덕수궁길점,1021,823,198,754,267,686,335,92,101,91,76,82,101,103,100,92,76,107,33.77521263669502,202005
도봉로2점,966,799,167,691,275,657,309,90,78,79,101,72,93,96,92,87,92,86,47.175219023779725,202005
도봉로점,1299,1084,215,955,344,873,426,125,115,124,115,112,118,131,110,118,120,111,34.73523985239852,202005
동구청로점,1337,1094,243,1003,334,907,430,118,115,127,125,102,134,134,141,115,120,106,35.261425959780624,202005
둔산로점,1123,918,205,828,295,761,362,107,108,96,110,91,96,115,99,93,98,110,20.347494553376908,202005
둔산서로점,1190,978,212,898,292,804,386,104,106,93,108,119,133,99,114,103,110,101,34.11554192229039,202005
둔산중로점,1125,904,221,839,286,760,365,91,101,106,113,92,100,109,98,108,114,93,34.86283185840708,202005
르노삼성대로점,1085,887,198,819,266,738,347,89,84,94,112,102,112,103,93,92,99,105,34.90642615558061,202005
마들로2점,1062,839,223,791,271,723,339,88,95,110,100,78,89,102,91,105,107,97,34.50297973778307,202005
마들로점,1487,1217,270,1078,409,1006,481,123,152,137,125,145,135,119,129,122,138,162,34.283483976992606,202005
마린시티1로점,948,772,176,699,249,640,308,79,80,85,98,73,94,81,94,78,88,98,33.90155440414508,202005
마포대로2점,1363,1105,258,1015,348,924,439,119,130,136,109,106,150,101,130,124,137,121,34.57918552036199,202005
마포대로점,1420,1213,207,1063,357,960,460,133,135,117,146,128,128,132,126,132,129,114,32.95713107996703,202005
망양로점,1366,1106,260,1000,366,927,439,124,110,130,116,131,123,136,120,120,122,134,34.445750452079565,202005
명지국제7로점,1186,961,225,863,323,805,381,115,97,121,116,112,124,105,111,93,96,96,35.47658688865765,202005
명지동점,1297,1053,244,945,352,876,421,109,112,120,119,109,139,128,130,101,112,118,34.882241215574545,202005
명지새동네길점,1187,985,202,881,306,803,384,122,112,107,118,105,116,91,96,104,107,109,33.89543147208122,202005
목공동로2점,1494,1183,311,1123,371,1010,484,128,127,139,135,129,165,112,147,154,141,117,34.696534234995774,202005
목공동로점,1189,961,228,901,288,804,385,106,106,104,110,98,117,104,120,107,110,107,47.07075962539022,202005
못골로점,1116,910,206,843,273,754,362,95,119,94,92,102,87,97,95,119,103,113,33.7978021978022,202005
무교로2점,1590,1316,274,1169,421,1080,510,115,153,128,153,146,130,149,144,169,142,161,34.753799392097264,202005
무교로점,875,704,171,646,229,593,282,74,71,85,82,69,89,96,91,77,65,76,33.15767045454545,202005
문예회관길점,1214,999,215,901,313,820,394,130,94,107,116,110,106,97,122,93,104,135,20.003003003003002,202005
민락수변로점,1315,1057,258,967,348,892,423,118,131,119,109,115,115,127,134,118,118,111,33.61021759697256,202005
방죽로점,1244,1014,230,937,307,846,398,109,111,119,120,104,109,111,111,124,114,112,34.16568047337278,202005
배재로점,1528,1252,276,1162,366,1033,495,132,143,128,135,136,138,139,160,126,164,127,33.82667731629393,202005
법원로2점,1345,1069,276,979,366,911,434,130,121,123,125,133,124,119,129,105,115,121,34.12254443405052,202005
법원로점,2310,1863,447,1663,647,1565,745,239,176,216,215,210,228,191,200,216,230,189,34.79441760601181,202005
보문로2점,1091,904,187,781,310,738,353,98,110,98,95,88,85,97,111,113,100,96,34.735619469026545,202005
보문로점,1188,964,224,884,304,807,381,100,123,103,101,108,102,101,116,128,106,100,34.628630705394194,202005
복수서로점,911,740,171,664,247,616,295,84,100,78,80,84,88,80,91,74,83,69,35.05135135135135,202005
봉선로점,1184,951,233,871,313,808,376,122,101,98,117,110,115,109,98,108,102,104,35.04311251314406,202005
봉화산로2점,1005,833,172,754,251,684,321,105,81,92,89,89,87,95,97,81,84,105,33.93517406962785,202005
봉화산로점,813,658,155,602,211,548,265,73,71,75,76,69,75,77,72,73,72,80,34.50911854103344,202005
부흥로점,1376,1105,271,1002,374,934,442,128,128,148,132,116,120,110,122,112,128,132,34.14932126696833,202005
북유성대로점,1311,1069,242,950,361,885,426,107,129,120,128,94,135,123,125,110,118,122,34.62020579981291,202005
분포로점,1550,1273,277,1153,397,1050,500,127,140,145,153,142,143,155,131,147,128,139,35.02749410840534,202005
비아로점,1537,1280,257,1117,420,1041,496,128,123,144,154,144,156,109,133,127,181,138,34.78671875,202005
사우중로점,1641,1333,308,1206,435,1115,526,155,170,156,147,143,169,139,126,154,140,142,34.80270067516879,202005
사직로2점,1039,847,192,769,270,702,337,86,94,94,105,87,103,88,103,97,90,92,34.30224321133412,202005
사직로점,2334,1912,422,1741,593,1582,752,213,203,209,225,222,245,197,191,204,211,214,34.68619246861925,202005
삼봉로2점,1364,1112,252,996,368,923,441,117,138,127,115,119,127,130,115,132,118,126,34.97392086330935,202005
삼봉로점,1035,879,156,760,275,701,334,79,110,79,115,101,99,75,91,105,87,94,33.5358361774744,202005
삼일대로2점,1005,816,189,752,253,680,325,98,90,91,99,85,90,87,107,83,93,82,34.36642156862745,202005
삼일대로점,1212,984,228,887,325,822,390,95,97,115,111,107,115,114,117,129,101,111,34.72357723577236,202005
상무공원로점,1425,1169,256,1058,367,967,458,118,104,128,124,126,144,136,121,149,136,139,34.88964927288281,202005
상무대로점,1125,932,193,857,268,766,359,116,97,106,100,97,118,104,96,94,92,105,34.657725321888414,202005
상무번영로점,916,745,171,673,243,623,293,96,62,80,84,87,75,78,89,80,72,113,48.33154362416107,202005
서남로점,1118,920,198,822,296,758,360,102,100,101,108,105,104,113,77,115,97,96,34.53478260869565,202005
서소문로2점,1029,857,172,771,258,696,333,93,88,91,90,98,71,97,85,109,98,109,35.11668611435239,202005
서소문로점,1279,1038,241,952,327,868,411,109,109,130,111,98,134,119,122,113,120,114,34.54431599229287,202005
서초중앙로2점,1247,1005,242,909,338,843,404,96,116,123,91,124,128,113,108,116,108,124,34.63084577114428,202005
서초중앙로3점,1092,897,195,794,298,749,343,95,99,100,107,107,102,106,103,84,81,108,34.30546265328874,202005
서초중앙로점,1157,933,224,851,306,784,373,113,105,94,102,117,112,111,102,88,106,107,33.461950696677384,202005
서하로점,1553,1251,302,1158,395,1052,501,133,142,155,132,155,141,158,126,146,138,127,34.14708233413269,202005
석봉로점,847,704,143,627,220,575,272,67,64,88,84,77,72,76,66,84,81,88,34.40909090909091,202005
성남대로점,1557,1268,289,1163,394,1059,498,130,139,150,152,131,127,146,152,142,151,137,34.905362776025235,202005
성내로2점,1307,1076,231,961,346,885,422,97,133,117,127,128,114,119,105,131,109,127,34.61895910780669,202005
성내로점,976,792,184,745,231,662,314,95,89,92,83,102,74,97,80,82,87,95,48.073232323232325,202005
성산동2점,1369,1128,241,997,372,931,438,96,130,127,160,91,138,141,104,131,114,137,35.1968085106383,202005
성산동점,1034,840,194,773,261,704,330,91,93,94,79,108,87,104,104,88,93,93,20.52857142857143,202005
세종대로2점,1059,891,168,773,286,715,344,109,77,124,85,77,86,103,108,95,96,99,34.05050505050505,202005
세종대로점,1186,960,226,884,302,806,380,114,102,111,112,104,96,109,103,103,108,124,34.55,202005
세종로점,1182,986,196,875,307,800,382,106,101,120,111,113,109,113,96,102,115,96,34.80324543610548,202005
송정공원로점,912,742,170,662,250,616,296,80,101,82,80,83,93,82,80,76,68,87,34.190026954177895,202005
송정해변로점,1570,1280,290,1145,425,1065,505,148,138,131,156,149,130,135,126,164,145,148,20.178125,202005
시흥대로2점,1006,818,188,731,275,679,327,95,88,103,69,93,81,86,99,97,97,98,34.19437652811736,202005
시흥대로점,1252,1017,235,919,333,844,408,120,124,117,125,116,105,112,103,99,107,124,34.2409046214356,202005
신갈마로점,1176,949,227,853,323,793,383,110,116,103,90,98,102,114,120,110,110,103,34.04109589041096,202005
신일동로점,1361,1105,256,998,363,919,442,124,122,111,132,133,128,130,112,125,119,125,35.58280542986425,202005
신일서로점,1274,1056,218,932,342,862,412,114,112,91,132,116,112,127,128,102,111,129,34.43560606060606,202005
안양천로2점,1147,927,220,867,280,774,373,96,118,78,105,120,94,114,90,114,108,110,34.687162891046384,202005
안양천로점,1215,956,259,868,347,822,393,100,108,107,128,116,121,102,123,101,100,109,34.59309623430963,202005
양재2점,1313,1052,261,982,331,894,419,121,112,137,120,125,128,111,100,127,111,121,34.7851711026616,202005
양재점,1213,998,215,902,311,818,395,98,113,114,109,112,127,117,97,108,123,95,34.800601202404806,202005
어등대로점,1215,991,224,889,326,823,392,98,107,110,113,100,129,108,117,105,118,110,34.55297679112008,202005
엑스포로점,1128,930,198,838,290,764,364,91,98,115,103,116,87,103,93,108,109,105,34.80967741935484,202005
연제로점,1436,1149,287,1094,342,976,460,138,146,133,136,138,123,123,141,124,128,106,34.33072236727589,202005
연희로2점,1427,1187,240,1056,371,969,458,138,135,119,130,152,136,121,137,121,123,115,35.13395113732098,202005
연희로점,1101,896,205,824,277,746,355,102,109,92,106,73,103,106,94,103,98,115,33.94419642857143,202005
영통구점,1092,868,224,832,260,738,354,89,98,110,91,83,98,92,102,125,94,110,34.973502304147466,202005
예술길점,1182,978,204,866,316,799,383,104,105,96,113,104,103,110,129,90,118,110,34.43353783231084,202005
온천천로점,1580,1284,296,1182,398,1076,504,147,152,130,148,128,158,134,151,141,141,150,34.767133956386296,202005
올림픽로2점,1392,1100,292,1045,347,941,451,116,133,125,127,130,107,129,133,135,128,129,20.425454545454546,202005
올림픽로점,1004,829,175,757,247,680,324,74,96,93,84,88,91,93,103,75,103,104,34.615199034981906,202005
용대로점,1070,861,209,793,277,728,342,102,80,95,97,106,102,89,108,85,103,103,33.96399535423926,202005
용아로점,1363,1125,238,1000,363,922,441,119,103,142,127,124,110,131,129,104,136,138,34.65777777777778,202005
용운동점,878,720,158,648,230,592,286,76,84,73,77,82,78,69,78,85,104,72,34.75833333333333,202005
우치로점,1156,962,194,872,284,783,373,102,115,122,95,106,101,107,101,99,106,102,47.727650727650726,202005
월계로2점,1034,832,202,754,280,700,334,70,103,93,105,106,97,87,100,89,83,101,34.37860576923077,202005
월계로점,1242,1006,236,926,316,842,400,109,114,113,109,119,114,103,109,122,118,112,19.8389662027833,202005
월드컵대로2점,913,745,168,655,258,618,295,79,85,84,91,73,88,84,96,59,73,101,34.21879194630873,202005
월드컵대로점,1146,947,199,848,298,777,369,108,92,85,99,112,130,108,105,95,113,99,34.71488912354805,202005
월드컵로2점,1431,1186,245,1052,379,971,460,122,123,118,137,123,137,135,141,145,125,125,34.20067453625632,202005
월드컵로점,944,758,186,688,256,636,308,88,80,97,82,78,75,85,86,96,87,90,34.031662269129285,202005
은평로2점,885,728,157,655,230,598,287,73,86,94,80,87,78,70,78,77,77,85,35.71291208791209,202005
은평로점,1247,998,249,943,304,844,403,105,108,115,96,121,126,119,117,120,91,129,34.02204408817635,202005
일산동구점,1167,938,229,882,285,789,378,113,105,82,98,100,111,116,105,101,104,132,34.73560767590618,202005
자양로2점,1088,874,214,818,270,738,350,97,92,106,98,87,102,99,106,103,106,92,34.23798627002288,202005
자양로점,1185,980,205,880,305,802,383,113,106,112,109,102,106,118,100,109,107,103,34.66326530612245,202005
장대로점,1250,1022,228,941,309,848,402,109,117,112,116,109,136,104,113,123,101,110,33.56849315068493,202005
장동로점,1006,820,186,739,267,679,327,101,90,83,83,102,91,95,100,86,83,92,34.1280487804878,202005
장승배기로2점,1188,949,239,864,324,804,384,128,100,129,99,108,103,101,102,104,111,103,34.25289778714436,202005
장승배기로점,1157,977,180,858,299,781,376,115,95,105,106,116,118,102,82,95,107,116,20.74002047082907,202005
재반로점,1239,1008,231,922,317,833,406,93,96,98,112,123,130,120,118,103,127,119,35.017857142857146,202005
절영로점,1492,1233,259,1101,391,1012,480,158,144,149,126,137,152,123,128,114,133,128,33.597729115977295,202005
절재로점,1402,1157,245,1026,376,950,452,135,138,141,120,126,130,130,118,116,122,126,34.51944684528954,202005
제중로점,1182,986,196,873,309,799,383,106,111,114,99,100,104,112,111,98,118,109,34.0395537525355,202005
조치원점,1189,972,217,884,305,810,379,97,95,115,114,130,108,115,88,114,94,119,33.842592592592595,202005
종로2점,1551,1265,286,1152,399,1051,500,162,126,135,145,138,126,129,155,138,155,142,34.30355731225296,202005
종로점,1093,888,205,816,277,738,355,114,112,88,92,107,89,96,97,101,104,93,34.77477477477478,202005
준법로점,1150,936,214,855,295,778,372,106,96,100,112,100,110,109,99,115,109,94,34.541666666666664,202005
중구로점,1491,1211,280,1098,393,1015,476,144,121,119,132,139,125,130,156,171,118,136,34.441783649876136,202005
중동2로점,727,590,137,554,173,493,234,79,57,82,60,78,54,52,61,65,70,69,33.63559322033898,202005
중앙대로2점,1398,1144,254,1051,347,943,455,112,125,126,123,116,125,137,132,135,131,136,34.34178321678322,202005
중앙대로점,2247,1843,404,1669,578,1520,727,213,192,180,203,180,217,229,187,215,215,216,34.78676071622355,202005
증심사길점,1313,1055,258,996,317,892,421,122,119,141,124,107,103,116,124,138,114,105,33.81232227488152,202005
창경궁로2점,1453,1199,254,1075,378,986,467,136,131,124,126,137,139,129,104,131,137,159,34.71809841534612,202005
창경궁로점,1281,1038,243,927,354,867,414,123,103,132,101,122,115,110,121,112,129,113,34.55973025048169,202005
처인구점,1034,830,204,747,287,699,335,82,109,90,101,94,88,97,79,91,93,110,35.08072289156627,202005
천호대로2점,1586,1280,306,1164,422,1076,510,140,142,143,139,159,144,128,150,142,154,145,33.50703125,202005
천호대로점,1011,853,158,765,246,683,328,82,92,92,99,100,80,88,101,107,85,85,34.98358733880422,202005
첨단과기로점,1342,1086,256,1009,333,905,437,132,128,114,118,125,130,117,115,116,141,106,33.865561694290975,202005
청계청로2점,1361,1105,256,1030,331,919,442,127,116,106,118,139,128,141,132,118,119,117,34.93393665158371,202005
청계청로점,910,727,183,690,220,613,297,96,73,104,88,89,86,66,77,75,80,76,34.98486932599725,202005
청사포로점,1270,1033,237,945,325,860,410,126,107,123,122,124,112,117,87,116,116,120,20.505324298160698,202005
태종로점,1197,972,225,893,304,810,387,126,109,100,104,110,124,102,103,113,111,95,35.37139917695473,202005
필문대로점,1182,957,225,901,281,799,383,115,111,108,98,114,116,106,105,102,93,114,34.4294670846395,202005
하남산단점,1032,839,193,790,242,699,333,89,93,105,92,107,88,85,103,97,87,86,35.39332538736591,202005
하리해안길점,1160,958,202,879,281,784,376,99,107,114,110,107,135,87,101,112,98,90,34.31002087682672,202005
하신번영로점,1521,1222,299,1094,427,1030,491,137,132,137,139,139,142,152,135,142,132,134,34.47626841243863,202005
하신중앙로점,1247,1004,243,927,320,841,406,100,127,118,117,120,93,126,105,117,108,116,34.3296812749004,202005
학감대로점,1424,1170,254,1046,378,963,461,131,128,126,133,143,121,135,135,112,137,123,34.976068376068376,202005
학동로2점,1455,1205,250,1054,401,986,469,125,136,130,162,123,156,116,132,128,110,137,34.72199170124481,202005
학동로점,1422,1177,245,1026,396,962,460,117,126,155,125,125,129,135,117,137,134,122,34.440951571792695,202005
한남로점,1039,852,187,767,272,705,334,96,85,108,85,121,85,98,76,89,100,96,34.759389671361504,202005
한누리대로점,1305,1063,242,953,352,881,424,108,132,132,114,129,103,123,132,102,107,123,34.8824082784572,202005
한밭대로점,1098,886,212,818,280,747,351,117,97,79,88,103,94,101,107,95,118,99,47.78781038374718,202005
해안새벽시장길점,1247,1026,221,945,302,840,407,116,100,111,113,130,108,122,116,113,110,108,34.599415204678365,202005
해운대로점,1437,1194,243,1052,385,974,463,147,140,119,125,125,144,134,117,124,134,128,33.88777219430486,202005
해운대해변로점,1029,869,160,760,269,696,333,92,77,96,101,93,83,80,95,93,129,90,20.418872266973533,202005
화곡로2점,1209,968,241,925,284,820,389,100,110,118,96,109,112,135,94,97,124,114,34.017561983471076,202005
화곡로점,1088,890,198,813,275,739,349,99,102,88,97,115,94,98,105,99,98,93,35.06741573033708,202005
화중로점,1183,961,222,884,299,805,378,114,96,103,100,100,116,112,120,94,110,118,33.4006243496358,202005
효덕로점,1338,1120,218,1013,325,910,428,116,132,123,129,135,99,122,130,128,118,106,33.691071428571426,202005
효원로점,826,678,148,595,231,560,266,80,62,85,69,76,69,75,67,69,91,83,34.78761061946903,202005
가덕해안로점,996,803,193,723,273,734,262,82,101,97,94,98,92,92,79,80,86,95,34.665006226650064,202006
가마산로2점,1459,1179,280,1087,372,1068,391,131,104,106,134,144,154,140,134,136,132,144,34.53095843935539,202006
가마산로점,1031,849,182,810,221,757,274,94,105,79,77,122,79,88,98,82,103,104,34.20141342756184,202006
감천항로점,995,808,187,760,235,731,264,93,92,97,87,86,85,87,83,78,106,101,33.95420792079208,202006
강남대로2점,1090,871,219,825,265,801,289,87,111,113,89,89,117,99,86,87,104,108,34.917336394948336,202006
강남대로점,1063,855,208,791,272,780,283,116,94,97,96,101,82,78,106,96,94,103,35.16842105263158,202006
강남점3점,1266,1040,226,920,346,928,338,117,118,104,132,109,105,135,113,105,116,112,34.5875,202006
경열로점,1154,972,182,833,321,847,307,121,105,91,121,105,105,101,110,92,105,98,35.10082304526749,202006
계룡로점,1384,1112,272,1008,376,1012,372,137,116,133,151,106,122,103,132,142,123,119,35.693345323741006,202006
계족로점,1144,918,226,851,293,838,306,110,108,118,90,105,99,100,102,115,91,106,34.694989106753816,202006
고산자로2점,1386,1113,273,1044,342,1017,369,125,108,123,116,116,146,128,128,134,133,129,34.20305480682839,202006
고산자로점,1031,858,173,763,268,759,272,93,100,81,112,90,84,92,106,91,95,87,34.24242424242424,202006
관악로2점,1406,1137,269,1050,356,1026,380,109,143,119,152,146,132,94,138,119,128,126,34.442392260334216,202006
관악로점,1115,932,183,832,283,815,300,120,100,92,99,92,98,111,97,96,97,113,34.26824034334764,202006
관저동로점,1446,1205,241,1068,378,1057,389,152,138,119,125,120,136,136,129,124,151,116,33.86473029045643,202006
광산로점,974,794,180,730,244,718,256,84,96,95,81,100,91,82,86,97,72,90,33.68261964735516,202006
광주여대길점,1205,974,231,896,309,880,325,114,92,107,125,127,111,99,110,105,116,99,34.4435318275154,202006
구덕로점,1169,968,201,866,303,857,312,103,101,86,117,107,100,118,114,105,113,105,47.89049586776859,202006
구청로점,877,740,137,618,259,645,232,73,92,86,83,91,70,78,76,78,79,71,33.76891891891892,202006
국제금융로2점,734,590,144,550,184,540,194,57,66,56,55,64,70,82,70,66,79,69,46.13220338983051,202006
국제금융로점,1353,1107,246,991,362,990,363,130,120,133,126,127,123,122,126,118,97,131,33.38301716350497,202006
금송로점,1269,1030,239,959,310,932,337,127,117,124,107,123,103,108,105,135,123,97,34.681553398058256,202006
금화로점,1291,1064,227,974,317,946,345,127,127,117,133,109,120,105,100,105,112,136,34.890037593984964,202006
기장대로점,1424,1163,261,1051,373,1045,379,134,142,138,118,125,135,127,113,131,120,141,34.54170249355116,202006
기흥점,1060,875,185,795,265,781,279,101,89,108,93,102,99,85,97,101,99,86,34.15542857142857,202006
낙동대로2점,1432,1193,239,1059,373,1051,381,121,125,134,136,128,136,149,128,128,126,121,33.46521374685666,202006
낙동대로점,1212,982,230,892,320,886,326,99,107,126,110,100,111,124,102,113,99,121,34.29735234215886,202006
낙동북로점,1106,915,191,814,292,815,291,93,120,99,101,106,104,98,88,92,109,96,34.664480874316936,202006
남동남로점,1350,1088,262,987,363,990,360,117,126,134,128,126,120,116,120,111,122,130,35.454963235294116,202006
남부순환로2점,1505,1209,296,1131,374,1105,400,138,138,138,138,126,136,138,151,139,128,135,34.355665839536805,202006
남부순환로점,1208,990,218,905,303,885,323,113,128,116,109,112,100,122,93,88,106,121,34.74444444444445,202006
남천동로점,976,800,176,731,245,715,261,80,92,95,86,96,98,93,95,85,84,72,33.795,202006
내방로점,1318,1073,245,964,354,964,354,122,120,98,132,137,110,120,108,115,130,126,20.02143522833178,202006
노해로2점,1625,1353,272,1183,442,1196,429,137,147,146,159,132,145,145,151,153,152,158,34.53362897265336,202006
노해로점,1172,964,208,850,322,856,316,103,112,107,106,108,130,103,122,89,91,101,34.07676348547718,202006
녹사평대로2점,1527,1249,278,1138,389,1117,410,130,110,135,140,159,137,149,155,139,139,134,34.00160128102482,202006
녹사평대로점,1346,1075,271,968,378,988,358,140,120,117,108,123,120,128,126,119,114,131,34.437209302325584,202006
다대동로점,1415,1136,279,1025,390,1033,382,117,128,117,113,122,155,105,156,130,137,135,33.40669014084507,202006
달맞이길점,1325,1073,252,951,374,971,354,121,137,99,115,134,119,104,128,116,135,117,34.654240447343895,202006
당산로2점,1354,1106,248,1017,337,994,360,128,110,122,105,114,147,132,140,120,117,119,34.12658227848101,202006
당산로점,1059,874,185,801,258,774,285,97,96,93,97,108,107,78,85,105,97,96,48.382151029748286,202006
대둔산로점,1439,1177,262,1057,382,1061,378,133,131,137,122,121,118,124,121,156,145,131,35.00339847068819,202006
대전로점,1149,950,199,892,257,846,303,102,97,101,104,105,126,110,121,102,98,83,47.96631578947368,202006
대종로점,1462,1190,272,1079,383,1075,387,115,141,136,150,123,118,131,139,139,133,137,34.5436974789916,202006
대흥로점,819,647,172,591,228,601,218,78,82,68,69,74,74,73,88,71,84,58,34.36166924265842,202006
덕남길점,1299,1071,228,992,307,949,350,124,132,119,121,124,108,116,114,115,103,123,35.472455648926235,202006
덕수궁길2점,1173,949,224,868,305,858,315,96,113,101,93,122,117,103,108,115,110,95,34.14541622760801,202006
덕수궁길점,1002,817,185,735,267,736,266,101,86,81,97,76,88,80,105,96,98,94,34.77845777233782,202006
도봉로2점,943,771,172,696,247,688,255,89,81,78,100,88,81,94,84,90,77,81,47.77172503242542,202006
도봉로점,1264,1041,223,930,334,923,341,112,108,115,132,111,102,113,125,122,127,97,34.267050912584054,202006
동구청로점,1286,1038,248,931,355,943,343,112,111,112,118,116,117,118,127,113,116,126,34.87861271676301,202006
둔산로점,1094,894,200,817,277,804,290,99,113,96,106,90,97,109,92,90,97,105,20.404921700223714,202006
둔산서로점,1150,923,227,852,298,843,307,101,97,84,116,100,96,104,123,102,114,113,35.05742145178765,202006
둔산중로점,1095,894,201,776,319,801,294,101,90,97,106,84,105,94,114,111,104,89,34.116331096196866,202006
르노삼성대로점,1051,857,194,749,302,769,282,92,101,83,87,97,102,87,113,101,102,86,34.844807467911316,202006
마들로2점,1028,845,183,742,286,755,273,96,97,82,93,88,90,111,93,95,94,89,34.78579881656805,202006
마들로점,1450,1158,292,1069,381,1067,383,152,138,135,130,135,135,118,108,141,117,141,34.41278065630397,202006
마린시티1로점,917,771,146,677,240,673,244,69,82,77,83,70,91,94,88,88,91,84,34.137483787289234,202006
마포대로2점,1328,1096,232,961,367,971,357,126,129,126,104,126,137,108,108,120,115,129,34.875,202006
마포대로점,1373,1114,259,1017,356,1010,363,121,114,115,129,151,98,156,120,113,126,130,34.254937163375224,202006
망양로점,1324,1094,230,980,344,972,352,103,122,142,136,116,141,113,109,116,125,101,34.52650822669104,202006
명지국제7로점,1152,930,222,845,307,842,310,108,101,115,108,100,94,93,126,114,109,84,34.883870967741935,202006
명지동점,1252,1031,221,935,317,922,330,105,121,112,123,113,112,118,119,95,114,120,34.742967992240544,202006
명지새동네길점,1146,934,212,854,292,840,306,113,104,114,105,100,104,87,101,97,98,123,34.936830835117775,202006
목공동로2점,1447,1194,253,1095,352,1060,387,123,133,129,135,134,137,140,132,139,123,122,34.47571189279732,202006
목공동로점,1149,920,229,835,314,844,305,116,119,106,88,115,109,96,97,102,96,105,47.676086956521736,202006
못골로점,1083,890,193,808,275,797,286,94,102,109,102,101,98,81,100,104,94,98,34.75168539325843,202006
무교로2점,1535,1248,287,1156,379,1122,413,148,142,139,137,149,142,139,132,131,111,165,34.20192307692308,202006
무교로점,851,680,171,606,245,624,227,81,84,79,77,77,69,81,78,78,83,64,34.86323529411764,202006
문예회관길점,1180,939,241,868,312,868,312,122,94,116,101,109,109,108,89,113,97,122,19.894568690095845,202006
민락수변로점,1264,1038,226,955,309,932,332,137,107,99,118,104,123,120,114,114,123,105,33.9373795761079,202006
방죽로점,1213,978,235,912,301,886,327,131,104,112,103,109,93,116,115,109,116,105,35.18609406952965,202006
배재로점,1475,1195,280,1098,377,1084,391,121,158,141,127,138,132,122,137,128,145,126,35.54393305439331,202006
법원로2점,1301,1042,259,956,345,950,351,128,123,122,107,112,109,119,133,123,117,108,34.87236084452975,202006
법원로점,2228,1845,383,1652,576,1633,595,185,228,187,187,196,202,212,215,212,206,198,34.67750677506775,202006
보문로2점,1052,862,190,766,286,770,282,103,100,103,84,102,82,95,76,102,97,108,34.812064965197216,202006
보문로점,1153,931,222,851,302,846,307,85,113,86,128,109,123,92,116,83,107,111,33.339419978517725,202006
복수서로점,885,722,163,656,229,647,238,74,88,88,82,75,74,78,89,87,69,81,35.27146814404432,202006
봉선로점,1148,938,210,844,304,838,310,108,100,80,108,124,98,110,89,107,108,116,33.81982942430704,202006
봉화산로2점,966,779,187,696,270,706,260,93,105,100,77,72,95,76,91,90,82,85,35.67394094993581,202006
봉화산로점,789,647,142,578,211,578,211,89,67,64,68,68,85,72,69,62,82,63,34.43894899536321,202006
부흥로점,1322,1068,254,977,345,971,351,134,121,114,114,133,108,142,115,114,106,121,34.31367041198502,202006
북유성대로점,1259,1017,242,967,292,923,336,103,139,106,91,113,106,110,109,126,133,123,34.67748279252704,202006
분포로점,1499,1241,258,1127,372,1100,399,153,136,139,137,133,117,141,141,118,130,154,34.273972602739725,202006
비아로점,1506,1216,290,1113,393,1106,400,133,136,133,137,131,140,150,139,142,129,136,34.0797697368421,202006
사우중로점,1590,1302,288,1165,425,1166,424,126,140,163,138,151,140,128,157,157,148,142,34.92319508448541,202006
사직로2점,1001,816,185,747,254,735,266,88,95,71,102,96,91,76,103,85,89,105,34.693627450980394,202006
사직로점,2269,1845,424,1665,604,1664,605,216,207,195,199,221,210,218,203,195,207,198,34.640108401084014,202006
삼봉로2점,1314,1069,245,982,332,964,350,113,141,134,112,123,96,128,122,119,124,102,34.916744621141255,202006
삼봉로점,997,807,190,719,278,729,268,81,109,99,94,72,89,85,115,93,82,78,34.817843866171,202006
삼일대로2점,976,791,185,738,238,717,259,74,78,82,79,89,91,84,96,94,110,99,34.21997471554994,202006
삼일대로점,1167,935,232,858,309,851,316,118,110,102,103,109,105,99,107,116,100,98,34.688770053475935,202006
상무공원로점,1383,1105,278,1036,347,1015,368,124,115,136,118,122,143,119,132,125,112,137,34.46515837104072,202006
상무대로점,1089,901,188,812,277,799,290,92,100,102,116,110,93,104,86,94,97,95,34.26637069922309,202006
상무번영로점,889,719,170,634,255,653,236,80,86,78,83,75,83,73,85,82,90,74,49.127955493741304,202006
서남로점,1090,887,203,802,288,800,290,113,106,110,95,81,91,94,109,87,117,87,34.87598647125141,202006
서소문로2점,1000,822,178,757,243,732,268,83,93,102,87,106,87,87,85,95,92,83,34.25912408759124,202006
서소문로점,1237,1022,215,932,305,908,329,112,113,115,129,101,111,108,112,113,115,108,34.683953033268104,202006
서초중앙로2점,1204,979,225,902,302,883,321,118,102,120,105,113,118,104,108,99,116,101,34.61797752808989,202006
서초중앙로3점,1057,857,200,785,272,773,284,84,102,98,91,90,99,85,102,86,100,120,34.981330221703615,202006
서초중앙로점,1115,925,190,821,294,818,297,93,113,95,116,102,105,110,94,103,85,99,34.723243243243246,202006
서하로점,1501,1231,270,1125,376,1099,402,149,135,134,134,116,145,132,151,145,130,130,34.222583265637695,202006
석봉로점,821,669,152,597,224,602,219,82,71,81,77,76,66,74,83,57,78,76,34.52765321375187,202006
성남대로점,1494,1225,269,1123,371,1097,397,140,136,133,142,138,126,133,151,115,144,136,34.04408163265306,202006
성내로2점,1267,1018,249,945,322,926,341,115,133,107,110,114,138,129,97,99,126,99,34.8614931237721,202006
성내로점,942,802,140,713,229,688,254,92,80,84,91,93,75,77,83,98,84,85,48.67206982543641,202006
성산동2점,1321,1071,250,984,337,966,355,111,118,117,112,108,106,126,129,122,136,136,33.58730158730159,202006
성산동점,1001,830,171,748,253,734,267,96,82,90,100,91,81,89,99,91,91,91,20.749397590361447,202006
세종대로2점,1025,834,191,758,267,755,270,92,105,89,82,99,86,87,113,83,94,95,33.96762589928058,202006
세종대로점,1147,943,204,870,277,841,306,103,93,104,110,117,104,95,101,106,112,102,35.088016967126194,202006
세종로점,1147,945,202,823,324,840,307,105,102,101,108,111,100,96,105,109,100,110,34.871957671957674,202006
송정공원로점,878,721,157,650,228,647,231,76,64,90,86,76,84,94,77,84,71,76,34.907073509015255,202006
송정해변로점,1536,1226,310,1126,410,1126,410,156,136,142,137,147,129,139,130,133,129,158,20.424143556280587,202006
시흥대로2점,976,821,155,731,245,713,263,93,99,88,88,91,89,77,87,85,90,89,33.752740560292324,202006
시흥대로점,1206,1009,197,902,304,885,321,112,118,124,106,124,103,113,116,92,82,116,34.69970267591675,202006
신갈마로점,1144,917,227,850,294,840,304,89,101,120,104,71,105,118,121,86,126,103,34.47873500545256,202006
신일동로점,1319,1097,222,983,336,968,351,114,123,125,97,110,114,131,120,115,136,134,34.14767547857794,202006
신일서로점,1230,998,232,882,348,901,329,111,113,113,107,116,111,114,115,121,100,109,35.04208416833667,202006
안양천로2점,1120,914,206,842,278,821,299,83,98,87,104,99,98,111,104,129,92,115,34.56126914660832,202006
안양천로점,1179,959,220,870,309,864,315,114,107,98,115,90,103,106,122,120,105,99,35.54848800834203,202006
양재2점,1267,1039,228,934,333,931,336,112,97,114,126,127,116,105,120,101,119,130,33.60538979788258,202006
양재점,1176,964,212,888,288,864,312,110,120,132,98,98,108,107,100,90,105,108,34.74896265560166,202006
어등대로점,1175,963,212,882,293,859,316,102,121,110,91,100,103,111,108,97,106,126,33.94184839044652,202006
엑스포로점,1087,888,199,807,280,798,289,96,99,104,96,98,92,88,103,120,89,102,34.677927927927925,202006
연제로점,1395,1122,273,1052,343,1023,372,147,121,134,121,140,103,142,103,132,123,129,34.52317290552585,202006
연희로2점,1384,1091,293,1009,375,1015,369,136,129,141,132,128,128,119,111,119,133,108,34.12648945921173,202006
연희로점,1058,873,185,771,287,776,282,93,94,95,86,101,101,91,96,106,100,95,34.69873997709049,202006
영통구점,1057,865,192,792,265,775,282,94,104,102,81,107,82,96,94,98,110,89,34.38034682080925,202006
예술길점,1143,938,205,866,277,837,306,95,108,104,123,90,108,110,101,86,107,111,35.91577825159915,202006
온천천로점,1531,1246,285,1112,419,1123,408,119,134,136,150,135,124,143,144,148,153,145,34.69422150882825,202006
올림픽로2점,1348,1116,232,994,354,986,362,135,109,124,108,128,122,123,135,120,117,127,20.467741935483872,202006
올림픽로점,970,784,186,722,248,710,260,73,96,94,98,91,80,98,94,96,75,75,34.67602040816327,202006
용대로점,1036,853,183,767,269,759,277,113,78,82,92,111,102,92,85,88,94,99,34.35287221570926,202006
용아로점,1326,1092,234,967,359,973,353,127,110,119,132,128,115,113,125,138,104,115,34.663003663003664,202006
용운동점,848,687,161,624,224,623,225,77,85,59,95,79,78,84,67,76,80,68,34.01310043668122,202006
우치로점,1117,915,202,812,305,819,298,93,95,102,106,98,104,104,113,104,99,99,48.048087431693986,202006
월계로2점,998,822,176,728,270,729,269,88,94,86,89,79,84,89,104,93,91,101,34.47566909975669,202006
월계로점,1206,996,210,879,327,885,321,106,90,107,108,124,110,117,112,112,109,111,20.505020080321284,202006
월드컵대로2점,887,722,165,666,221,650,237,88,67,76,76,85,78,80,70,87,91,89,33.40720221606648,202006
월드컵대로점,1109,907,202,806,303,812,297,86,96,95,86,118,99,113,113,106,102,95,33.63175303197354,202006
월드컵로2점,1379,1116,263,1003,376,1011,368,133,127,135,130,126,109,123,114,129,127,126,34.39874551971326,202006
월드컵로점,904,742,162,672,232,660,244,85,83,79,75,82,82,91,76,78,84,89,33.902964959568735,202006
은평로2점,851,697,154,650,201,624,227,86,68,82,81,77,78,98,67,78,69,67,34.761836441893834,202006
은평로점,1206,1007,199,928,278,883,323,105,98,101,107,126,97,93,109,129,130,111,33.887785501489574,202006
일산동구점,1119,918,201,816,303,824,295,117,82,107,89,136,102,87,117,89,92,101,34.60130718954248,202006
자양로2점,1050,857,193,787,263,768,282,93,99,83,82,83,97,115,106,101,97,94,35.038506417736286,202006
자양로점,1150,937,213,845,305,840,310,96,100,117,107,123,99,101,102,91,117,97,35.54962646744931,202006
장대로점,1205,978,227,865,340,886,319,99,109,127,102,116,100,108,107,113,100,124,33.805725971370144,202006
장동로점,971,782,189,735,236,711,260,99,89,90,90,93,79,84,80,104,74,89,34.668797953964194,202006
장승배기로2점,1147,936,211,843,304,841,306,93,111,124,119,104,101,99,100,90,110,96,34.55555555555556,202006
장승배기로점,1108,904,204,835,273,808,300,89,105,95,101,97,118,88,104,100,111,100,20.83407079646018,202006
재반로점,1208,1001,207,885,323,887,321,106,109,113,110,114,133,112,91,116,107,97,34.723276723276726,202006
절영로점,1438,1188,250,1080,358,1054,384,150,134,103,136,139,123,132,137,133,118,133,34.01262626262626,202006
절재로점,1350,1113,237,991,359,990,360,112,109,136,133,131,124,104,123,117,115,146,34.43755615453728,202006
제중로점,1150,956,194,875,275,841,309,101,95,98,122,113,110,95,121,103,94,98,34.90690376569037,202006
조치원점,1145,921,224,859,286,840,305,95,97,117,108,108,106,116,80,102,110,106,34.44951140065147,202006
종로2점,1503,1227,276,1113,390,1099,404,128,127,150,140,121,141,155,129,143,132,137,34.640586797066014,202006
종로점,1055,882,173,783,272,774,281,86,111,117,99,81,102,92,94,92,82,99,34.56235827664399,202006
준법로점,1113,892,221,830,283,815,298,99,106,112,109,90,97,92,105,112,97,94,34.785874439461885,202006
중구로점,1441,1195,246,1053,388,1060,381,124,147,136,131,129,123,129,131,126,136,129,35.05188284518828,202006
중동2로점,703,585,118,515,188,516,187,76,57,52,72,63,70,63,64,65,70,51,33.593162393162395,202006
중앙대로2점,1350,1087,263,1013,337,992,358,118,110,117,121,108,145,118,114,141,130,128,34.55197792088317,202006
중앙대로점,2178,1797,381,1596,582,1596,582,188,191,220,201,175,186,186,219,194,208,210,34.02170283806344,202006
증심사길점,1260,1017,243,928,332,922,338,131,119,118,111,115,94,116,113,116,120,107,33.97443461160275,202006
창경궁로2점,1413,1158,255,1037,376,1035,378,114,117,131,119,141,109,144,123,136,156,123,35.126943005181346,202006
창경궁로점,1231,1002,229,896,335,898,333,111,100,118,102,107,104,122,123,120,111,113,35.21457085828343,202006
처인구점,999,815,184,739,260,734,265,87,98,107,91,89,87,78,89,93,94,86,33.8,202006
천호대로2점,1541,1277,264,1137,404,1131,410,133,146,150,143,112,143,137,153,137,144,143,33.98355520751762,202006
천호대로점,973,789,184,723,250,713,260,91,97,108,79,85,78,83,86,76,107,83,34.47908745247148,202006
첨단과기로점,1298,1040,258,932,366,954,344,113,132,104,120,114,134,105,134,99,123,120,34.74807692307692,202006
청계청로2점,1334,1092,242,967,367,980,354,127,120,120,130,135,133,110,124,102,124,109,34.60989010989011,202006
청계청로점,884,719,165,679,205,646,238,81,71,71,91,71,91,78,92,81,81,76,34.696801112656466,202006
청사포로점,1242,1012,230,934,308,910,332,129,122,107,118,124,109,99,105,109,111,109,19.90513833992095,202006
태종로점,1148,922,226,867,281,844,304,131,94,114,102,105,109,107,102,93,83,108,34.23861171366595,202006
필문대로점,1149,930,219,841,308,844,305,115,96,101,106,105,112,99,114,92,113,96,35.155913978494624,202006
하남산단점,993,813,180,731,262,728,265,87,78,91,78,97,84,90,108,85,98,97,35.32472324723247,202006
하리해안길점,1116,890,226,816,300,819,297,111,107,106,96,105,82,104,112,116,101,76,34.651685393258425,202006
하신번영로점,1468,1180,288,1105,363,1074,394,140,131,121,135,150,143,133,131,132,123,129,35.41271186440678,202006
하신중앙로점,1199,984,215,883,316,876,323,120,111,108,115,114,100,129,103,88,106,105,34.4369918699187,202006
학감대로점,1388,1120,268,1007,381,1017,371,125,122,142,121,122,130,140,118,122,103,143,34.35,202006
학동로2점,1406,1159,247,1056,350,1034,372,138,132,113,133,128,122,133,133,125,125,124,34.278688524590166,202006
학동로점,1381,1113,268,1005,376,1014,367,126,119,125,104,137,115,134,131,123,138,129,33.81940700808625,202006
한남로점,1006,841,165,744,262,736,270,106,72,106,73,93,83,95,104,94,94,86,34.52318668252081,202006
한누리대로점,1271,1056,215,953,318,932,339,117,112,117,113,102,119,116,124,122,107,122,34.48011363636363,202006
한밭대로점,1053,858,195,787,266,771,282,89,93,100,112,98,101,86,99,90,96,89,47.38461538461539,202006
해안새벽시장길점,1206,969,237,902,304,885,321,111,122,106,106,101,107,114,107,110,103,119,35.10526315789474,202006
해운대로점,1377,1115,262,1024,353,1012,365,137,116,115,138,142,113,119,122,137,118,120,35.18834080717489,202006
해운대해변로점,996,820,176,739,257,732,264,86,94,79,98,107,81,87,93,95,89,87,20.60609756097561,202006
화곡로2점,1160,955,205,838,322,853,307,97,109,123,106,110,82,104,97,110,113,109,35.41884816753927,202006
화곡로점,1058,863,195,788,270,775,283,111,106,94,85,86,93,104,90,95,103,91,34.52375434530707,202006
화중로점,1143,940,203,850,293,840,303,101,116,88,136,109,84,114,107,104,97,87,35.0,202006
효덕로점,1297,1088,209,990,307,953,344,127,129,119,103,120,104,113,109,129,122,122,34.96231617647059,202006
효원로점,788,641,147,573,215,578,210,84,90,72,64,49,74,76,74,59,64,82,34.29641185647426,202006
가덕해안로점,1038,846,192,788,250,772,266,89,76,99,106,100,95,93,92,112,89,87,33.59101654846336,202007
가마산로2점,1520,1241,279,1116,404,1132,388,127,140,133,134,142,138,147,127,156,127,149,34.48106365834005,202007
가마산로점,1063,862,201,790,273,789,274,101,91,94,87,83,101,111,98,99,100,98,34.45939675174014,202007
감천항로점,1034,837,197,754,280,764,270,109,112,98,84,87,96,87,84,88,81,108,34.5089605734767,202007
강남대로2점,1132,934,198,827,305,839,293,104,102,96,114,105,118,88,98,113,101,93,34.29550321199144,202007
강남대로점,1093,894,199,853,240,811,282,77,97,88,107,101,120,102,98,105,95,103,34.6096196868009,202007
강남점3점,1307,1090,217,950,357,970,337,103,112,118,118,134,125,117,106,121,134,119,34.17155963302752,202007
경열로점,1182,960,222,882,300,874,308,106,111,91,103,100,97,114,103,119,132,106,34.26354166666667,202007
계룡로점,1426,1178,248,1046,380,1063,363,140,123,134,134,129,118,127,131,135,129,126,34.840407470288625,202007
계족로점,1195,988,207,899,296,886,309,97,94,114,110,127,114,86,105,117,114,117,34.6336032388664,202007
고산자로2점,1428,1196,232,1045,383,1061,367,133,135,120,128,126,115,136,144,127,133,131,35.00585284280937,202007
고산자로점,1059,881,178,777,282,789,270,100,92,98,104,106,106,81,98,88,94,92,34.19182746878547,202007
관악로2점,1466,1202,264,1076,390,1087,379,136,146,133,137,128,123,139,121,134,132,137,34.82279534109817,202007
관악로점,1156,940,216,860,296,854,302,107,93,112,125,104,93,104,99,112,96,111,34.52978723404255,202007
관저동로점,1496,1217,279,1110,386,1108,388,143,136,137,128,143,121,140,129,119,156,144,34.31470829909614,202007
광산로점,999,806,193,754,245,739,260,103,93,91,84,82,90,92,98,98,82,86,34.14267990074442,202007
광주여대길점,1240,1017,223,940,300,921,319,93,114,105,114,118,109,117,114,116,125,115,34.42182890855457,202007
구덕로점,1217,1000,217,914,303,902,315,108,115,114,105,100,100,107,128,114,110,116,46.926,202007
구청로점,909,729,180,674,235,673,236,76,87,76,94,64,100,76,99,96,84,57,34.48559670781893,202007
국제금융로2점,756,617,139,567,189,558,198,63,69,84,71,65,52,79,74,58,72,69,46.6839546191248,202007
국제금융로점,1402,1124,278,1046,356,1040,362,108,140,137,120,133,134,129,115,155,108,123,34.071174377224196,202007
금송로점,1309,1067,242,970,339,970,339,111,121,123,128,118,121,117,105,109,121,135,35.04873477038426,202007
금화로점,1336,1117,219,988,348,991,345,125,110,129,122,120,133,122,120,115,117,123,34.55953446732319,202007
기장대로점,1489,1214,275,1139,350,1108,381,118,144,126,135,127,128,139,123,141,156,152,34.629324546952226,202007
기흥점,1093,900,193,815,278,814,279,117,103,96,94,111,108,85,108,95,99,77,34.721111111111114,202007
낙동대로2점,1495,1240,255,1132,363,1112,383,152,122,133,153,141,107,130,130,136,164,127,34.32258064516129,202007
낙동대로점,1249,1019,230,941,308,923,326,99,119,127,124,121,95,128,114,100,112,110,35.00785083415113,202007
낙동북로점,1151,957,194,852,299,854,297,106,103,116,107,117,88,101,104,103,105,101,34.337513061650995,202007
남동남로점,1394,1144,250,1031,363,1036,358,122,122,114,122,124,140,124,121,130,124,151,34.15472027972028,202007
남부순환로2점,1552,1275,277,1161,391,1153,399,142,152,148,150,137,149,139,136,143,113,143,33.89411764705882,202007
남부순환로점,1244,1017,227,943,301,928,316,118,108,96,129,118,134,109,113,104,100,115,34.65978367748279,202007
남천동로점,997,804,193,730,267,738,259,84,84,98,95,82,79,94,95,98,103,85,34.450248756218905,202007
내방로점,1369,1113,256,1029,340,1018,351,129,126,123,128,134,121,115,130,106,138,119,20.10871518418688,202007
노해로2점,1675,1369,306,1234,441,1243,432,136,156,136,158,157,148,150,140,170,158,166,34.54784514243974,202007
노해로점,1212,957,255,890,322,896,316,129,97,101,112,112,105,110,109,111,114,112,34.66353187042842,202007
녹사평대로2점,1573,1265,308,1179,394,1161,412,154,153,143,149,154,146,154,135,121,150,114,34.41660079051383,202007
녹사평대로점,1401,1114,287,1026,375,1038,363,119,142,142,117,112,133,124,112,122,162,116,34.46858168761221,202007
다대동로점,1454,1195,259,1090,364,1083,371,122,133,149,131,149,138,136,122,137,114,123,34.58493723849372,202007
달맞이길점,1369,1129,240,1003,366,1017,352,115,138,130,113,116,120,123,129,124,126,135,34.79362267493357,202007
당산로2점,1394,1148,246,1037,357,1035,359,137,123,120,107,135,128,130,141,119,134,120,34.248257839721255,202007
당산로점,1098,876,222,821,277,815,283,95,106,119,105,102,87,103,99,99,90,93,48.43949771689498,202007
대둔산로점,1491,1225,266,1085,406,1107,384,132,144,128,133,131,128,141,133,136,155,130,34.884897959183675,202007
대전로점,1179,980,199,884,295,874,305,111,102,104,111,115,95,116,96,110,108,111,47.81530612244898,202007
대종로점,1519,1234,285,1160,359,1124,395,152,126,129,139,157,156,121,139,127,149,124,35.060777957860616,202007
대흥로점,852,698,154,641,211,631,221,76,95,67,76,66,71,80,69,83,80,89,34.146131805157594,202007
덕남길점,1336,1106,230,992,344,994,342,127,129,118,116,120,119,115,109,129,124,130,34.8499095840868,202007
덕수궁길2점,1213,995,218,900,313,900,313,125,111,95,110,101,110,102,120,117,102,120,35.03115577889447,202007
덕수궁길점,1030,821,209,750,280,762,268,93,92,101,117,78,88,90,86,97,107,81,34.649208282582215,202007
도봉로2점,976,802,174,727,249,724,252,75,96,85,102,100,93,90,82,96,85,72,49.270573566084785,202007
도봉로점,1309,1072,237,964,345,969,340,108,109,136,140,125,129,107,116,113,113,113,34.35727611940298,202007
동구청로점,1325,1085,240,969,356,983,342,100,118,124,104,107,127,137,123,135,113,137,34.40552995391705,202007
둔산로점,1120,891,229,821,299,828,292,91,100,99,94,99,98,102,110,112,100,115,20.095398428731762,202007
둔산서로점,1182,969,213,862,320,876,306,106,114,99,126,96,100,109,102,98,122,110,34.21362229102167,202007
둔산중로점,1121,932,189,821,300,830,291,98,107,106,101,99,94,121,90,87,119,99,34.4549356223176,202007
르노삼성대로점,1096,893,203,803,293,813,283,100,96,94,90,100,97,106,111,117,95,90,34.432250839865624,202007
마들로2점,1065,866,199,810,255,790,275,95,99,97,90,102,77,97,114,93,104,97,34.315242494226325,202007
마들로점,1491,1209,282,1114,377,1107,384,140,130,134,135,131,123,147,136,134,147,134,34.08850289495451,202007
마린시티1로점,935,754,181,692,243,694,241,73,72,101,72,83,103,90,101,72,82,86,35.09018567639257,202007
마포대로2점,1364,1118,246,982,382,1014,350,121,116,122,110,128,114,120,129,143,118,143,33.879248658318424,202007
마포대로점,1426,1154,272,1061,365,1056,370,141,118,126,148,132,132,136,127,116,123,127,34.24696707105719,202007
망양로점,1376,1102,274,1029,347,1023,353,122,110,138,115,118,146,113,122,113,140,139,34.774954627949185,202007
명지국제7로점,1183,988,195,877,306,883,300,108,129,107,115,105,112,119,104,104,105,75,34.33805668016194,202007
명지동점,1308,1039,269,973,335,969,339,119,102,125,112,118,130,107,137,118,121,119,34.304138594802694,202007
명지새동네길점,1183,965,218,897,286,880,303,107,115,123,120,115,97,100,98,106,98,104,34.20103626943005,202007
목공동로2점,1495,1240,255,1082,413,1110,385,151,124,142,148,133,127,131,138,139,123,139,34.55241935483871,202007
목공동로점,1185,970,215,869,316,880,305,89,88,106,110,118,108,115,104,134,110,103,49.07938144329897,202007
못골로점,1117,905,212,849,268,831,286,96,101,101,103,78,113,121,101,100,94,109,34.32596685082873,202007
무교로2점,1582,1299,283,1173,409,1180,402,136,156,144,159,143,160,144,149,133,129,129,34.3387220939184,202007
무교로점,876,695,181,624,252,653,223,70,87,82,81,80,91,71,75,69,101,69,34.1410071942446,202007
문예회관길점,1217,1010,207,896,321,904,313,106,109,93,109,121,108,123,112,109,117,110,20.35247524752475,202007
민락수변로점,1314,1088,226,961,353,974,340,117,128,122,132,124,133,104,115,108,120,111,35.002757352941174,202007
방죽로점,1251,1041,210,904,347,929,322,126,125,110,117,102,118,114,101,121,111,106,34.10566762728146,202007
배재로점,1516,1257,259,1126,390,1122,394,148,135,134,125,149,138,135,138,134,147,133,34.7557677008751,202007
법원로2점,1349,1116,233,990,359,1002,347,127,122,144,104,128,90,119,119,123,119,154,34.556451612903224,202007
법원로점,2315,1863,452,1734,581,1723,592,200,240,219,214,218,205,221,197,200,193,208,34.263553408480945,202007
보문로2점,1097,910,187,818,279,815,282,103,90,99,101,100,101,99,102,97,98,107,33.77582417582418,202007
보문로점,1180,955,225,857,323,875,305,101,107,103,116,115,105,109,103,103,98,120,33.91204188481675,202007
복수서로점,917,762,155,683,234,680,237,80,76,84,95,84,73,72,91,83,88,91,34.38582677165354,202007
봉선로점,1184,972,212,874,310,880,304,105,106,88,126,106,124,106,101,110,117,95,33.93930041152263,202007
봉화산로2점,1005,845,160,747,258,746,259,102,87,77,92,92,98,91,100,92,76,98,34.51242603550296,202007
봉화산로점,821,667,154,607,214,609,212,78,64,80,86,62,76,84,78,64,71,78,34.608695652173914,202007
부흥로점,1368,1119,249,1004,364,1016,352,145,131,120,128,126,131,118,99,125,141,104,34.474530831099194,202007
북유성대로점,1298,1060,238,938,360,960,338,116,124,142,119,121,107,109,105,95,130,130,34.08490566037736,202007
분포로점,1552,1258,294,1158,394,1153,399,145,148,129,156,130,127,146,145,154,132,140,34.790143084260734,202007
비아로점,1546,1296,250,1146,400,1144,402,142,133,143,143,148,156,148,121,155,135,122,34.604166666666664,202007
사우중로점,1644,1334,310,1227,417,1221,423,154,132,139,152,155,137,165,173,153,130,154,34.96101949025487,202007
사직로2점,1028,826,202,765,263,757,271,96,100,88,98,90,83,90,100,89,100,94,34.96610169491525,202007
사직로점,2341,1904,437,1744,597,1736,605,237,176,231,194,197,207,213,207,235,230,214,34.55829831932773,202007
삼봉로2점,1363,1128,235,989,374,1011,352,126,113,117,139,139,135,110,128,124,117,115,34.930851063829785,202007
삼봉로점,1034,861,173,750,284,767,267,96,89,106,97,116,71,99,95,86,97,82,34.47386759581882,202007
삼일대로2점,1006,834,172,743,263,743,263,92,84,103,86,95,89,85,96,98,89,89,34.907673860911274,202007
삼일대로점,1219,998,221,898,321,905,314,108,119,98,118,106,88,119,117,118,111,117,33.86773547094188,202007
상무공원로점,1434,1158,276,1077,357,1063,371,139,110,128,124,128,135,150,116,114,131,159,34.938687392055265,202007
상무대로점,1116,903,213,849,267,828,288,109,82,86,119,104,120,104,103,93,90,106,34.40863787375415,202007
상무번영로점,909,732,177,695,214,676,233,102,85,83,68,87,80,85,89,85,75,70,47.41803278688525,202007
서남로점,1118,917,201,810,308,828,290,103,80,105,101,98,97,102,100,117,106,109,34.82333696837514,202007
서소문로2점,1039,843,196,787,252,769,270,105,83,106,102,91,81,117,100,97,76,81,35.226571767497035,202007
서소문로점,1289,1047,242,956,333,956,333,115,105,141,111,129,115,111,102,112,137,111,35.18242597898758,202007
서초중앙로2점,1244,1032,212,916,328,923,321,105,96,102,104,119,131,119,113,126,116,113,34.684108527131784,202007
서초중앙로3점,1098,918,180,828,270,815,283,99,102,97,89,100,102,93,110,101,108,97,34.65795206971678,202007
서초중앙로점,1157,929,228,841,316,858,299,101,95,115,104,103,103,97,95,140,98,106,34.23789020452099,202007
서하로점,1550,1248,302,1140,410,1153,397,147,138,148,150,138,125,151,142,142,130,139,35.374198717948715,202007
석봉로점,846,690,156,624,222,628,218,80,74,65,72,66,89,94,79,81,76,70,34.46376811594203,202007
성남대로점,1543,1258,285,1151,392,1145,398,125,135,156,135,147,133,147,142,137,136,150,35.00397456279809,202007
성내로2점,1313,1075,238,957,356,973,340,120,115,122,122,111,133,133,98,122,117,120,33.644651162790694,202007
성내로점,975,773,202,720,255,722,253,81,82,95,86,92,97,106,78,81,79,98,46.48382923673997,202007
성산동2점,1368,1119,249,1020,348,1019,349,128,119,116,134,132,133,122,118,119,124,123,34.734584450402146,202007
성산동점,1027,827,200,773,254,767,260,101,105,84,98,111,76,88,87,110,74,93,19.85006045949214,202007
세종대로2점,1062,878,184,807,255,789,273,76,105,103,114,96,111,88,102,82,95,90,34.17312072892938,202007
세종대로점,1190,982,208,902,288,882,308,120,113,104,104,109,107,107,92,112,107,115,33.935845213849284,202007
세종로점,1184,958,226,904,280,879,305,115,108,97,116,104,113,93,112,117,110,99,33.971816283924845,202007
송정공원로점,915,766,149,676,239,680,235,82,84,83,77,98,92,79,84,88,73,75,35.25848563968668,202007
송정해변로점,1572,1291,281,1173,399,1172,400,122,127,127,142,140,155,154,155,150,159,141,20.61735089078234,202007
시흥대로2점,1001,839,162,728,273,743,258,93,97,80,102,74,104,95,99,79,90,88,33.97735399284863,202007
시흥대로점,1245,1053,192,905,340,923,322,95,110,114,104,135,104,148,110,113,114,98,34.484330484330485,202007
신갈마로점,1185,960,225,893,292,880,305,112,90,101,128,117,97,116,115,110,111,88,34.41875,202007
신일동로점,1368,1146,222,987,381,1011,357,131,103,142,113,136,132,127,112,120,125,127,34.090750436300176,202007
신일서로점,1274,1040,234,963,311,946,328,117,112,136,119,122,105,110,103,107,136,107,34.176923076923075,202007
안양천로2점,1158,963,195,870,288,859,299,109,107,120,101,103,111,100,108,106,91,102,34.691588785046726,202007
안양천로점,1215,1007,208,895,320,898,317,102,118,113,110,99,108,102,107,124,107,125,35.10824230387289,202007
양재2점,1312,1064,248,946,366,975,337,123,148,149,111,121,106,111,120,119,108,96,34.25751879699248,202007
양재점,1212,1015,197,878,334,902,310,116,98,98,94,133,106,110,110,121,99,127,34.66699507389163,202007
어등대로점,1221,1017,204,922,299,906,315,139,107,115,97,107,106,106,120,116,117,91,35.05211406096362,202007
엑스포로점,1123,908,215,816,307,834,289,100,100,97,106,99,108,98,92,112,109,102,34.48348017621145,202007
연제로점,1423,1166,257,1043,380,1054,369,137,146,146,113,139,132,132,105,102,138,133,33.80617495711835,202007
연희로2점,1426,1148,278,1051,375,1054,372,131,117,117,127,145,138,119,137,132,130,133,34.40853658536585,202007
연희로점,1089,873,216,819,270,810,279,101,110,94,100,92,102,98,120,98,100,74,34.33104238258878,202007
영통구점,1099,873,226,819,280,818,281,101,109,105,97,94,99,98,100,104,98,94,34.6815578465063,202007
예술길점,1178,961,217,865,313,872,306,119,101,94,127,114,114,101,117,97,99,95,34.481789802289285,202007
온천천로점,1591,1293,298,1190,401,1180,411,143,142,148,169,141,141,139,157,140,110,161,34.36117556071152,202007
올림픽로2점,1399,1151,248,1020,379,1036,363,131,124,141,143,140,122,122,116,116,113,131,20.65942658557776,202007
올림픽로점,1005,823,182,763,242,748,257,101,105,92,109,96,81,91,83,80,103,64,35.266099635479954,202007
용대로점,1068,906,162,782,286,795,273,104,91,102,93,105,88,105,101,88,88,103,33.941501103752756,202007
용아로점,1352,1127,225,1040,312,1000,352,102,125,128,112,124,139,125,121,132,131,113,34.078970718722275,202007
용운동점,877,713,164,648,229,651,226,63,70,83,81,64,72,80,72,98,106,88,34.94670406732118,202007
우치로점,1151,940,211,861,290,858,293,119,98,104,95,115,113,96,110,88,103,110,47.86595744680851,202007
월계로2점,1033,874,159,750,283,765,268,81,95,102,94,110,90,95,99,97,92,78,33.52288329519451,202007
월계로점,1243,1012,231,914,329,920,323,124,108,100,117,93,136,124,107,116,121,97,20.451581027667984,202007
월드컵대로2점,912,743,169,665,247,678,234,99,82,78,61,90,88,78,80,83,66,107,35.165545087483174,202007
월드컵대로점,1157,948,209,861,296,858,299,105,101,109,96,106,98,93,110,103,110,126,35.19303797468354,202007
월드컵로2점,1437,1158,279,1074,363,1068,369,124,145,122,143,117,130,149,131,130,130,116,35.236614853195164,202007
월드컵로점,945,768,177,719,226,703,242,84,91,84,106,96,84,76,66,70,89,99,34.4375,202007
은평로2점,878,705,173,647,231,652,226,77,89,76,76,61,77,81,80,90,92,79,34.716312056737586,202007
은평로점,1251,1006,245,919,332,927,324,118,89,121,113,110,95,109,124,117,129,126,34.84890656063618,202007
일산동구점,1159,931,228,846,313,858,301,104,107,87,110,119,102,125,95,100,103,107,34.70998925886144,202007
자양로2점,1095,916,179,799,296,814,281,105,86,90,90,99,104,103,108,111,119,80,34.98580786026201,202007
자양로점,1181,945,236,835,346,881,300,114,110,90,119,99,91,110,91,111,124,122,33.974603174603175,202007
장대로점,1252,1011,241,946,306,925,327,109,114,116,98,119,113,126,112,110,108,127,34.30662710187933,202007
장동로점,1004,804,200,750,254,748,256,87,87,87,92,94,105,89,92,99,89,83,33.86940298507463,202007
장승배기로2점,1182,976,206,878,304,883,299,101,111,99,116,101,100,121,97,114,107,115,35.32069672131148,202007
장승배기로점,1159,948,211,868,291,858,301,109,96,117,112,105,113,95,100,100,109,103,20.490506329113924,202007
재반로점,1246,1008,238,927,319,924,322,102,123,129,116,116,121,112,100,106,112,109,34.861111111111114,202007
절영로점,1478,1193,285,1070,408,1094,384,146,124,128,112,137,140,137,153,119,138,144,34.24643755238893,202007
절재로점,1394,1121,273,1038,356,1035,359,128,116,117,119,114,131,123,127,117,148,154,34.61462979482605,202007
제중로점,1178,970,208,896,282,873,305,108,102,112,99,117,94,102,117,127,101,99,34.88556701030928,202007
조치원점,1183,968,215,906,277,878,305,113,107,111,110,93,116,108,118,94,102,111,34.44731404958678,202007
종로2점,1546,1246,300,1173,373,1149,397,112,140,119,139,161,139,134,153,141,167,141,34.630016051364365,202007
종로점,1091,918,173,807,284,808,283,89,101,93,88,110,98,100,86,108,112,106,35.15359477124183,202007
준법로점,1153,948,205,851,302,854,299,102,94,117,93,110,106,95,103,104,126,103,34.80696202531646,202007
중구로점,1486,1230,256,1104,382,1101,385,138,135,132,142,144,127,135,131,131,144,127,34.99837398373984,202007
중동2로점,732,598,134,547,185,541,191,61,58,67,78,65,60,64,67,89,61,62,34.80769230769231,202007
중앙대로2점,1392,1150,242,1016,376,1031,361,123,126,135,127,135,142,106,151,115,110,122,34.79304347826087,202007
중앙대로점,2249,1857,392,1647,602,1672,577,246,180,207,204,212,213,207,191,209,192,188,35.06354334948842,202007
증심사길점,1310,1073,237,970,340,972,338,119,126,129,112,122,116,107,114,128,118,119,34.0232991612302,202007
창경궁로2점,1461,1164,297,1096,365,1084,377,121,134,123,130,116,137,160,128,135,121,156,34.56099656357388,202007
창경궁로점,1269,1033,236,953,316,941,328,108,134,105,116,110,123,97,118,127,104,127,34.13552758954501,202007
처인구점,1031,855,176,742,289,763,268,82,79,90,106,84,93,100,109,95,97,96,34.31345029239766,202007
천호대로2점,1576,1274,302,1171,405,1170,406,152,147,137,149,156,130,150,137,147,128,143,35.0392464678179,202007
천호대로점,1008,816,192,733,275,750,258,85,94,100,90,89,87,94,114,81,92,82,35.541666666666664,202007
첨단과기로점,1338,1122,216,963,375,993,345,122,116,134,121,126,123,93,148,123,117,115,34.74420677361854,202007
청계청로2점,1368,1107,261,989,379,1020,348,147,125,131,116,142,113,119,114,131,128,102,34.968383017163504,202007
청계청로점,914,729,185,683,231,679,235,77,79,75,78,89,81,96,88,81,80,90,33.86145404663923,202007
청사포로점,1280,1060,220,953,327,950,330,121,114,119,127,132,110,124,112,102,115,104,20.463207547169812,202007
태종로점,1180,965,215,883,297,879,301,114,105,108,109,99,113,112,105,95,106,114,34.89637305699482,202007
필문대로점,1175,949,226,853,322,870,305,118,101,102,96,111,98,101,109,102,114,123,34.59957850368809,202007
하남산단점,1037,861,176,775,262,769,268,104,96,92,104,85,96,90,77,94,95,104,34.13937282229965,202007
하리해안길점,1147,943,204,808,339,857,290,124,102,106,105,101,106,101,102,88,107,105,33.8016967126193,202007
하신번영로점,1514,1248,266,1106,408,1123,391,126,139,156,146,121,131,115,136,144,162,138,35.18269230769231,202007
하신중앙로점,1245,1018,227,903,342,925,320,133,118,101,106,95,101,120,130,106,111,124,33.86444007858546,202007
학감대로점,1424,1153,271,1051,373,1055,369,150,142,119,131,130,135,134,135,109,127,112,34.11708586296618,202007
학동로2점,1451,1220,231,1079,372,1077,374,129,141,125,123,127,130,104,149,140,135,148,34.820491803278685,202007
학동로점,1429,1160,269,1040,389,1060,369,129,113,148,149,136,130,119,109,133,127,136,33.74396551724138,202007
한남로점,1034,855,179,746,288,767,267,106,89,103,74,83,87,108,80,112,97,95,34.51111111111111,202007
한누리대로점,1298,1071,227,944,354,961,337,132,109,116,113,125,101,121,119,111,125,126,34.82166199813258,202007
한밭대로점,1094,902,192,780,314,812,282,100,104,102,103,112,98,89,108,95,93,90,46.95232815964523,202007
해안새벽시장길점,1240,1020,220,928,312,920,320,110,114,108,109,129,105,103,131,120,103,108,34.786274509803924,202007
해운대로점,1419,1153,266,1089,330,1060,359,125,129,130,128,130,134,140,115,131,131,126,33.87944492627927,202007
해운대해변로점,1033,835,198,754,279,767,266,102,90,92,105,95,93,106,90,91,96,73,20.45748502994012,202007
화곡로2점,1213,1019,194,909,304,900,313,110,112,106,111,86,126,130,119,92,110,111,34.19234543670265,202007
화곡로점,1090,885,205,792,298,806,284,92,95,99,114,100,90,92,112,85,110,101,34.93785310734463,202007
화중로점,1180,938,242,849,331,875,305,123,113,129,98,108,121,88,105,110,103,82,35.3134328358209,202007
효덕로점,1339,1109,230,999,340,995,344,145,131,124,118,120,108,123,108,117,123,122,33.892696122633005,202007
효원로점,822,654,168,612,210,610,212,66,83,71,78,59,78,85,76,73,76,77,34.22477064220183,202007
가덕해안로점,1034,846,188,764,270,701,333,97,101,74,87,105,87,89,103,97,104,90,34.82387706855792,202008
가마산로2점,1522,1218,304,1153,369,1030,492,146,127,142,153,135,150,129,121,129,156,134,34.42528735632184,202008
가마산로점,1069,867,202,791,278,724,345,103,83,92,95,98,98,109,96,88,105,102,35.239907727797004,202008
감천항로점,1032,857,175,780,252,699,333,85,88,89,79,91,110,97,83,105,100,105,34.477246207701285,202008
강남대로2점,1124,940,184,823,301,762,362,106,96,98,91,90,100,112,115,93,115,108,33.87021276595745,202008
강남대로점,1079,894,185,816,263,728,351,91,103,85,98,84,117,112,102,90,97,100,34.51118568232662,202008
강남점3점,1297,1057,240,997,300,885,412,119,114,114,127,125,133,111,124,119,120,91,34.15042573320719,202008
경열로점,1182,950,232,878,304,799,383,105,106,115,122,103,106,107,92,118,103,105,35.04631578947368,202008
계룡로점,1435,1147,288,1058,377,970,465,120,147,126,92,140,141,132,128,121,125,163,34.22929380993897,202008
계족로점,1186,961,225,866,320,803,383,92,97,93,103,112,117,99,131,110,113,119,34.221644120707595,202008
고산자로2점,1422,1162,260,1057,365,966,456,112,137,148,130,123,135,131,137,119,117,133,34.230636833046475,202008
고산자로점,1059,871,188,793,266,719,340,98,93,114,103,99,87,106,91,83,90,95,34.234213547646384,202008
관악로2점,1463,1162,301,1086,377,989,474,124,139,121,131,122,164,125,128,125,145,139,33.774526678141136,202008
관악로점,1162,954,208,851,311,787,375,110,108,121,97,127,109,81,95,96,109,109,34.843815513626836,202008
관저동로점,1489,1216,273,1107,382,1008,481,138,127,135,145,159,131,122,126,137,129,140,34.31496710526316,202008
광산로점,1004,824,180,737,267,683,321,84,89,100,80,89,84,89,102,98,99,90,34.932038834951456,202008
광주여대길점,1231,1001,230,911,320,837,394,107,102,117,112,107,118,113,118,107,107,123,34.13586413586414,202008
구덕로점,1218,998,220,911,307,825,393,103,109,123,122,96,103,102,113,114,103,130,49.03306613226453,202008
구청로점,912,763,149,677,235,618,294,79,76,97,87,83,92,90,72,69,85,82,34.158584534731325,202008
국제금융로2점,758,618,140,568,190,514,244,91,62,53,62,67,76,64,72,75,59,77,48.150485436893206,202008
국제금융로점,1399,1136,263,1029,370,945,454,128,145,144,109,119,121,126,105,147,133,122,34.33098591549296,202008
금송로점,1301,1066,235,992,309,887,414,109,119,127,112,115,111,130,112,115,125,126,34.79549718574109,202008
금화로점,1334,1117,217,994,340,904,430,120,123,107,104,147,120,127,107,139,124,116,34.36347358997314,202008
기장대로점,1484,1208,276,1122,362,1006,478,150,138,131,118,133,155,134,122,136,120,147,34.99420529801324,202008
기흥점,1088,881,207,802,286,737,351,99,100,101,90,102,90,106,77,116,108,99,34.928490351872874,202008
낙동대로2점,1492,1197,295,1101,391,1010,482,125,143,122,145,129,127,122,144,143,145,147,34.25396825396825,202008
낙동대로점,1240,1015,225,939,301,837,403,101,123,105,114,93,122,111,108,123,120,120,33.902463054187194,202008
낙동북로점,1162,955,207,855,307,784,378,100,90,97,99,114,117,112,105,107,104,117,33.94450261780105,202008
남동남로점,1406,1153,253,1034,372,953,453,119,125,135,135,124,141,112,121,123,132,139,34.67476149176063,202008
남부순환로2점,1550,1276,274,1156,394,1049,501,137,150,137,147,133,136,135,143,141,152,139,34.495297805642636,202008
남부순환로점,1250,1016,234,921,329,845,405,112,129,106,112,130,106,98,131,98,113,115,34.493110236220474,202008
남천동로점,998,804,194,729,269,678,320,89,123,82,93,70,89,91,82,102,78,99,34.59701492537314,202008
내방로점,1365,1100,265,979,386,926,439,123,121,129,121,128,124,122,132,124,118,123,20.003636363636364,202008
노해로2점,1676,1353,323,1250,426,1138,538,138,138,158,166,159,154,154,171,145,139,154,34.33407243163341,202008
노해로점,1215,1001,214,918,297,823,392,129,106,127,97,112,111,109,112,110,102,100,34.05894105894106,202008
녹사평대로2점,1583,1281,302,1182,401,1073,510,131,137,139,130,165,152,161,134,152,154,128,33.902419984387194,202008
녹사평대로점,1403,1161,242,1017,386,946,457,155,129,134,133,114,128,117,109,130,133,121,34.47631352282515,202008
다대동로점,1454,1208,246,1072,382,984,470,137,118,117,121,143,129,140,149,130,131,139,33.73261589403973,202008
달맞이길점,1371,1109,262,1021,350,928,443,121,120,117,127,152,124,119,113,118,123,137,35.20288548241659,202008
당산로2점,1402,1153,249,1043,359,949,453,138,105,107,130,149,117,118,143,142,128,125,34.518647007805725,202008
당산로점,1095,890,205,824,271,741,354,92,94,122,94,108,97,89,96,106,99,98,48.306741573033705,202008
대둔산로점,1489,1200,289,1092,397,1011,478,127,124,132,152,133,131,136,132,151,122,149,33.93416666666667,202008
대전로점,1180,961,219,867,313,799,381,106,98,106,114,100,120,103,111,118,104,100,48.75650364203954,202008
대종로점,1505,1234,271,1117,388,1021,484,130,156,144,122,117,150,123,147,156,140,120,34.35899513776337,202008
대흥로점,857,685,172,638,219,579,278,80,86,77,73,93,64,62,88,84,71,79,34.48321167883212,202008
덕남길점,1340,1080,260,993,347,904,436,119,135,140,103,114,102,119,131,108,145,124,34.495370370370374,202008
덕수궁길2점,1217,997,220,882,335,827,390,115,104,106,124,88,121,125,115,107,105,107,33.65596790371114,202008
덕수궁길점,1030,841,189,750,280,701,329,88,101,93,88,96,98,84,102,102,91,87,35.023781212841854,202008
도봉로2점,975,786,189,739,236,658,317,89,90,89,71,82,88,107,90,83,98,88,47.67430025445292,202008
도봉로점,1307,1056,251,948,359,883,424,110,137,113,117,126,130,114,120,111,114,115,34.71306818181818,202008
동구청로점,1339,1103,236,1007,332,911,428,113,114,117,117,109,116,123,127,120,147,136,34.85947416137806,202008
둔산로점,1121,929,192,832,289,762,359,114,101,96,96,117,91,99,107,85,105,110,20.481162540365986,202008
둔산서로점,1191,984,207,883,308,806,385,100,102,113,106,107,121,111,100,118,91,122,33.978658536585364,202008
둔산중로점,1123,876,247,823,300,757,366,95,107,90,111,91,112,92,107,108,118,92,35.05707762557078,202008
르노삼성대로점,1091,886,205,793,298,744,347,110,93,101,101,108,88,93,108,88,103,98,33.67720090293454,202008
마들로2점,1064,872,192,780,284,719,345,103,92,79,100,105,98,110,76,94,91,116,34.31880733944954,202008
마들로점,1482,1208,274,1112,370,1003,479,140,133,131,125,151,122,119,124,138,152,147,35.22019867549669,202008
마린시티1로점,941,770,171,707,234,634,307,83,85,83,76,91,96,93,83,82,87,82,34.47012987012987,202008
마포대로2점,1369,1122,247,1007,362,929,440,113,132,117,123,130,111,116,134,127,135,131,34.973262032085564,202008
마포대로점,1428,1160,268,1087,341,967,461,145,143,134,143,130,119,108,146,122,121,117,34.21637931034483,202008
망양로점,1376,1140,236,1026,350,932,444,130,136,130,124,115,124,133,113,111,133,127,34.349122807017544,202008
명지국제7로점,1186,965,221,874,312,806,380,105,114,109,119,102,106,101,100,99,112,119,34.73160621761658,202008
명지동점,1309,1074,235,980,329,889,420,115,123,118,121,131,130,122,123,102,121,103,33.72718808193669,202008
명지새동네길점,1183,955,228,876,307,801,382,102,101,97,99,118,107,98,103,101,128,129,34.39476439790576,202008
목공동로2점,1486,1209,277,1098,388,1008,478,146,123,139,141,108,123,145,136,139,137,149,34.62117452440033,202008
목공동로점,1188,980,208,872,316,803,385,123,107,109,102,108,103,113,104,109,94,116,47.679591836734694,202008
못골로점,1128,946,182,856,272,764,364,82,102,110,105,104,91,116,100,119,94,105,33.723044397463,202008
무교로2점,1585,1266,319,1150,435,1072,513,130,141,145,138,147,137,149,164,146,125,163,35.10031595576619,202008
무교로점,881,721,160,655,226,594,287,78,79,77,63,83,92,72,85,72,86,94,35.61165048543689,202008
문예회관길점,1217,968,249,912,305,823,394,107,113,132,107,115,105,110,91,114,98,125,20.18388429752066,202008
민락수변로점,1309,1075,234,954,355,885,424,108,114,125,130,119,106,118,124,111,142,112,34.55813953488372,202008
방죽로점,1242,1003,239,919,323,842,400,117,102,103,113,100,107,133,110,123,107,127,34.09172482552343,202008
배재로점,1518,1234,284,1127,391,1032,486,136,137,148,134,131,141,137,151,120,127,156,34.57293354943274,202008
법원로2점,1337,1088,249,991,346,907,430,135,103,142,124,129,118,112,125,108,115,126,34.27389705882353,202008
법원로점,2297,1854,443,1718,579,1559,738,185,217,224,221,212,217,210,194,190,200,227,34.45738942826321,202008
보문로2점,1093,897,196,786,307,742,351,120,87,89,99,86,101,93,115,101,99,103,34.15161649944259,202008
보문로점,1170,965,205,888,282,795,375,108,105,99,107,98,120,106,121,81,101,124,35.094300518134716,202008
복수서로점,917,756,161,690,227,620,297,89,84,89,81,80,87,84,64,80,90,89,34.34391534391534,202008
봉선로점,1185,961,224,886,299,799,386,105,106,124,107,111,119,111,92,94,123,93,34.27055150884495,202008
봉화산로2점,1000,812,188,732,268,677,323,95,92,111,104,99,94,70,89,90,83,73,33.90024630541872,202008
봉화산로점,817,656,161,633,184,554,263,86,73,68,66,77,84,80,63,80,74,66,35.35060975609756,202008
부흥로점,1361,1094,267,1006,355,925,436,115,108,121,133,121,137,117,136,139,108,126,34.515539305301644,202008
북유성대로점,1299,1067,232,932,367,882,417,118,100,107,112,102,117,117,134,144,112,136,34.79194001874414,202008
분포로점,1546,1244,302,1172,374,1049,497,164,137,147,152,131,139,125,130,152,133,136,34.27893890675241,202008
비아로점,1552,1274,278,1155,397,1053,499,137,132,144,133,131,160,140,132,134,156,153,33.949764521193096,202008
사우중로점,1645,1335,310,1234,411,1113,532,166,137,134,160,153,136,164,154,136,157,148,34.450187265917606,202008
사직로2점,1035,831,204,754,281,701,334,82,90,100,85,95,86,89,105,117,99,87,34.00962695547533,202008
사직로점,2334,1897,437,1747,587,1584,750,212,207,205,204,205,230,213,220,218,198,222,34.275698471270424,202008
삼봉로2점,1369,1109,260,1018,351,925,444,121,129,108,126,140,134,129,141,109,108,124,35.19296663660956,202008
삼봉로점,1037,837,200,761,276,701,336,92,82,103,92,98,93,89,107,86,97,98,34.36798088410992,202008
삼일대로2점,1000,788,212,758,242,675,325,96,75,97,93,107,112,85,82,81,102,70,33.77791878172589,202008
삼일대로점,1213,974,239,883,330,826,387,109,112,123,107,110,127,116,91,107,103,108,33.96303901437371,202008
상무공원로점,1428,1161,267,1058,370,968,460,131,131,128,113,138,140,128,129,129,116,145,34.571059431524546,202008
상무대로점,1129,937,192,851,278,763,366,89,96,103,91,110,100,113,118,92,102,115,34.972251867662756,202008
상무번영로점,918,750,168,703,215,621,297,87,81,83,75,108,84,75,84,81,82,78,47.31466666666667,202008
서남로점,1129,914,215,813,316,767,362,104,99,103,102,96,120,106,103,96,99,101,35.25164113785558,202008
서소문로2점,1022,831,191,775,247,691,331,86,85,93,107,100,80,99,90,91,92,99,33.97352587244284,202008
서소문로점,1276,1041,235,943,333,870,406,113,149,116,105,118,106,111,111,117,109,121,34.216138328530256,202008
서초중앙로2점,1238,1028,210,917,321,836,402,105,116,134,121,107,121,102,108,124,92,108,34.46011673151751,202008
서초중앙로3점,1098,924,174,805,293,740,358,90,101,94,103,91,93,120,94,110,102,100,34.637445887445885,202008
서초중앙로점,1153,957,196,841,312,780,373,101,101,122,93,99,103,124,129,94,103,84,34.56008359456635,202008
서하로점,1553,1274,279,1147,406,1053,500,134,150,148,138,127,147,137,133,142,134,163,34.42621664050235,202008
석봉로점,853,694,159,634,219,579,274,77,102,75,78,78,69,81,81,65,72,75,34.51585014409222,202008
성남대로점,1548,1271,277,1127,421,1052,496,148,133,148,172,140,112,155,142,130,136,132,34.78756884343037,202008
성내로2점,1312,1054,258,971,341,889,423,116,121,136,111,117,96,125,104,142,127,117,33.88045540796964,202008
성내로점,979,802,177,690,289,665,314,84,95,93,98,84,86,100,74,86,92,87,46.908977556109726,202008
성산동2점,1358,1118,240,1012,346,919,439,113,131,124,130,129,126,120,114,122,134,115,35.085867620751344,202008
성산동점,1034,854,180,776,258,698,336,90,87,100,101,85,85,88,83,99,106,110,20.47658079625293,202008
세종대로2점,1066,874,192,777,289,724,342,94,94,123,90,101,100,105,81,94,105,79,34.35469107551487,202008
세종대로점,1178,973,205,870,308,796,382,99,100,101,109,113,129,101,114,96,110,106,34.60123329907503,202008
세종로점,1185,959,226,865,320,802,383,107,99,118,105,109,112,102,105,122,96,110,33.361835245046926,202008
송정공원로점,905,752,153,672,233,613,292,87,83,84,80,72,80,95,78,79,89,78,34.808510638297875,202008
송정해변로점,1593,1299,294,1190,403,1081,512,158,133,167,151,158,134,146,145,142,116,143,20.463433410315627,202008
시흥대로2점,1007,837,170,715,292,680,327,86,79,80,94,97,103,89,77,106,90,106,34.67383512544803,202008
시흥대로점,1239,1022,217,938,301,840,399,119,106,97,133,104,100,115,121,118,106,120,34.08904109589041,202008
신갈마로점,1187,962,225,869,318,809,378,113,106,117,119,108,110,95,105,102,110,102,34.5987525987526,202008
신일동로점,1371,1118,253,1004,367,928,443,123,115,111,111,140,131,107,134,128,144,127,34.80500894454383,202008
신일서로점,1278,1046,232,915,363,864,414,116,116,98,126,129,103,106,138,110,116,120,34.85755258126195,202008
안양천로2점,1141,938,203,872,269,774,367,110,97,88,112,105,102,107,110,93,110,107,34.67164179104478,202008
안양천로점,1215,971,244,905,310,825,390,117,112,107,110,127,103,104,80,116,126,113,34.42739443872296,202008
양재2점,1308,1060,248,968,340,885,423,97,134,112,100,126,133,132,128,120,122,104,35.01792452830189,202008
양재점,1215,997,218,908,307,823,392,113,95,98,116,102,106,129,109,113,127,107,35.10230692076229,202008
어등대로점,1225,1008,217,917,308,827,398,104,120,109,114,108,102,106,117,109,108,128,34.135912698412696,202008
엑스포로점,1117,921,196,819,298,756,361,91,101,100,100,92,108,107,94,111,112,101,34.4842562432139,202008
연제로점,1424,1191,233,1051,373,962,462,140,132,132,125,116,135,141,117,139,120,127,34.36020151133501,202008
연희로2점,1425,1152,273,1017,408,968,457,137,130,111,128,132,133,139,121,113,131,150,34.33506944444444,202008
연희로점,1091,878,213,807,284,737,354,96,82,106,115,98,113,84,85,102,98,112,34.25170842824601,202008
영통구점,1099,895,204,779,320,747,352,102,75,95,95,89,115,90,114,110,105,109,35.21899441340782,202008
예술길점,1185,978,207,882,303,800,385,112,102,99,106,118,109,106,111,111,107,104,34.348670756646214,202008
온천천로점,1588,1244,344,1164,424,1072,516,162,140,124,142,142,140,152,141,136,157,152,34.298231511254016,202008
올림픽로2점,1385,1154,231,1024,361,939,446,109,125,128,118,137,128,136,141,122,121,120,20.366551126516466,202008
올림픽로점,998,826,172,741,257,676,322,92,91,89,94,87,87,86,94,90,101,87,34.2409200968523,202008
용대로점,1069,878,191,786,283,725,344,105,96,89,96,94,108,88,78,103,100,112,34.210706150341686,202008
용아로점,1368,1102,266,1009,359,926,442,134,137,118,126,141,119,114,117,115,128,119,34.49637023593466,202008
용운동점,886,732,154,670,216,599,287,89,75,86,81,69,75,83,73,80,109,66,35.099726775956285,202008
우치로점,1148,924,224,854,294,777,371,99,112,106,114,106,118,98,89,96,107,103,47.75757575757576,202008
월계로2점,1035,833,202,764,271,702,333,99,95,97,101,88,83,104,85,96,88,99,34.25090036014406,202008
월계로점,1251,1018,233,921,330,845,406,107,114,116,106,115,78,119,136,115,131,114,20.24557956777996,202008
월드컵대로2점,918,764,154,703,215,624,294,88,86,78,82,94,89,83,78,68,86,86,34.57853403141361,202008
월드컵대로점,1150,953,197,866,284,777,373,107,90,108,103,115,100,90,110,116,100,111,35.554039874081845,202008
월드컵로2점,1422,1161,261,1069,353,964,458,126,106,124,125,148,126,127,139,143,134,124,34.521102497846684,202008
월드컵로점,949,771,178,719,230,641,308,83,85,79,88,88,82,81,91,87,79,106,34.945525291828794,202008
은평로2점,890,714,176,647,243,605,285,68,82,76,86,87,85,82,74,84,84,82,33.70448179271709,202008
은평로점,1240,1030,210,918,322,840,400,110,108,121,110,103,108,119,124,104,128,105,34.38252427184466,202008
일산동구점,1156,944,212,872,284,778,378,118,103,107,121,96,96,99,102,111,94,109,33.898305084745765,202008
자양로2점,1091,877,214,787,304,740,351,94,92,95,105,102,118,104,96,88,88,109,34.82212086659065,202008
자양로점,1185,971,214,885,300,801,384,118,116,104,113,112,86,100,110,117,108,101,34.026776519052525,202008
장대로점,1248,1034,214,926,322,843,405,118,115,103,105,117,108,125,112,108,119,118,34.297872340425535,202008
장동로점,1008,829,179,766,242,682,326,106,89,102,90,92,91,87,82,93,78,98,34.26658624849216,202008
장승배기로2점,1193,972,221,887,306,807,386,126,113,109,103,102,108,108,99,113,112,100,34.07818930041152,202008
장승배기로점,1159,960,199,863,296,787,372,92,107,97,109,117,122,102,112,99,97,105,20.335416666666667,202008
재반로점,1258,1031,227,949,309,855,403,118,113,126,109,96,130,117,98,120,126,105,33.904946653734235,202008
절영로점,1491,1225,266,1139,352,1011,480,139,137,120,137,125,143,136,137,146,148,123,34.350204081632654,202008
절재로점,1400,1155,245,1036,364,949,451,125,139,118,135,103,137,118,130,136,118,141,34.43809523809524,202008
제중로점,1190,970,220,891,299,803,387,105,109,103,115,131,91,108,106,103,112,107,33.995876288659794,202008
조치원점,1189,964,225,864,325,810,379,102,123,97,115,107,123,112,104,95,91,120,35.136929460580916,202008
종로2점,1553,1262,291,1120,433,1053,500,144,141,148,155,152,145,133,143,134,138,120,33.63946117274168,202008
종로점,1101,908,193,815,286,746,355,99,100,103,104,102,95,102,114,92,77,113,34.67400881057269,202008
준법로점,1159,939,220,845,314,786,373,100,106,107,117,94,114,87,112,106,100,116,34.58572949946752,202008
중구로점,1495,1222,273,1123,372,1011,484,132,140,152,129,126,140,140,149,131,123,133,34.44517184942717,202008
중동2로점,723,594,129,542,181,491,232,71,75,55,71,50,71,67,81,63,69,50,34.974747474747474,202008
중앙대로2점,1399,1131,268,1011,388,947,452,120,130,120,124,124,124,123,127,135,132,140,34.10344827586207,202008
중앙대로점,2250,1842,408,1657,593,1525,725,215,196,212,190,201,201,225,198,207,215,190,34.930510314875136,202008
증심사길점,1301,1051,250,943,358,877,424,130,119,116,130,104,106,112,114,136,125,109,34.32825880114177,202008
창경궁로2점,1464,1169,295,1075,389,993,471,139,136,131,139,133,130,132,134,120,113,157,34.74508126603935,202008
창경궁로점,1285,1051,234,950,335,872,413,124,116,108,124,106,140,109,117,111,109,121,34.353948620361564,202008
처인구점,1034,846,188,776,258,701,333,100,99,98,101,89,84,83,95,96,100,89,34.30260047281324,202008
천호대로2점,1580,1311,269,1146,434,1073,507,127,154,142,135,143,132,146,150,152,166,133,34.23417238749047,202008
천호대로점,1006,805,201,732,274,683,323,96,87,88,91,91,94,111,83,87,90,88,33.982608695652175,202008
첨단과기로점,1332,1106,226,986,346,901,431,125,123,99,110,127,118,129,122,126,123,130,34.59403254972875,202008
청계청로2점,1370,1101,269,998,372,926,444,125,117,136,143,130,113,107,126,117,125,131,34.271571298819254,202008
청계청로점,910,724,186,676,234,617,293,81,89,90,83,89,92,71,81,87,78,69,34.51243093922652,202008
청사포로점,1265,1033,232,928,337,853,412,105,106,108,123,98,127,118,116,123,114,127,20.04840271055179,202008
태종로점,1191,986,205,882,309,809,382,89,110,103,103,90,104,106,114,130,113,129,34.8052738336714,202008
필문대로점,1182,979,203,896,286,802,380,107,98,113,116,120,100,107,114,110,106,91,35.31767109295199,202008
하남산단점,1032,839,193,776,256,696,336,93,82,85,108,97,99,92,86,84,102,104,34.225268176400476,202008
하리해안길점,1152,933,219,858,294,783,369,97,107,119,112,103,99,103,91,101,110,110,33.543408360128616,202008
하신번영로점,1515,1253,262,1102,413,1030,485,129,151,140,123,130,140,163,146,143,121,129,34.90343176376696,202008
하신중앙로점,1251,1063,188,897,354,850,401,110,101,101,123,113,129,125,106,99,126,118,34.85700846660395,202008
학감대로점,1434,1169,265,1069,365,969,465,142,125,122,128,133,122,135,128,144,136,119,34.16595380667237,202008
학동로2점,1461,1197,264,1093,368,989,472,136,146,138,122,128,138,138,142,137,110,126,33.79365079365079,202008
학동로점,1429,1166,263,1063,366,967,462,110,122,137,126,134,134,141,138,114,147,126,35.06432246998285,202008
한남로점,1040,848,192,776,264,708,332,95,90,85,95,87,92,108,103,89,95,101,34.553066037735846,202008
한누리대로점,1306,1054,252,1004,302,884,422,119,137,118,111,110,117,109,123,130,107,125,33.926944971537004,202008
한밭대로점,1098,901,197,812,286,741,357,110,96,104,108,79,113,98,89,115,79,107,47.20199778024417,202008
해안새벽시장길점,1245,1027,218,915,330,843,402,120,119,95,120,108,101,106,113,120,114,129,34.5491723466407,202008
해운대로점,1422,1155,267,1057,365,969,453,115,134,122,128,136,143,124,127,151,113,129,34.62164502164502,202008
해운대해변로점,1032,852,180,747,285,699,333,77,92,103,86,83,100,100,95,103,100,93,19.663145539906104,202008
화곡로2점,1219,977,242,871,348,824,395,110,117,90,104,107,121,114,111,116,125,104,34.48004094165814,202008
화곡로점,1089,905,184,803,286,737,352,107,98,88,99,74,96,111,97,104,113,102,34.67624309392265,202008
화중로점,1176,951,225,886,290,797,379,109,102,99,112,118,103,130,92,109,101,101,35.02208201892744,202008
효덕로점,1333,1098,235,997,336,901,432,137,117,129,121,115,125,119,99,124,108,139,34.21129326047359,202008
효원로점,821,680,141,601,220,557,264,67,65,102,70,69,70,86,77,67,71,77,35.29117647058823,202008
가덕해안로점,1006,825,181,753,253,739,267,83,90,95,92,86,105,69,100,96,88,102,34.77454545454545,202009
가마산로2점,1468,1178,290,1105,363,1074,394,142,147,125,126,146,132,133,127,134,116,140,34.83955857385399,202009
가마산로점,1027,837,190,738,289,753,274,96,74,88,85,93,69,109,106,101,108,98,34.2831541218638,202009
감천항로점,1002,825,177,765,237,735,267,98,82,100,92,84,87,94,85,85,108,87,34.196363636363635,202009
강남대로2점,1092,902,190,783,309,800,292,88,100,86,114,98,97,102,80,103,111,113,34.09645232815964,202009
강남대로점,1052,857,195,788,264,773,279,87,96,103,99,96,116,96,93,94,80,92,34.64644107351225,202009
강남점3점,1265,1047,218,940,325,928,337,112,109,126,94,129,106,101,126,117,127,118,35.407831900668576,202009
경열로점,1145,933,212,861,284,837,308,108,102,97,113,93,112,104,109,111,98,98,34.650589496248664,202009
계룡로점,1377,1111,266,1008,369,1008,369,124,121,117,147,130,134,121,122,116,135,110,35.05760576057606,202009
계족로점,1149,943,206,851,298,844,305,103,104,88,85,123,105,86,113,130,119,93,34.30222693531283,202009
고산자로2점,1387,1125,262,1013,374,1015,372,136,115,141,123,119,114,141,129,128,122,119,34.61688888888889,202009
고산자로점,1038,843,195,751,287,760,278,99,107,92,100,90,101,108,91,83,77,90,35.119810201660734,202009
관악로2점,1411,1159,252,1066,345,1037,374,114,126,135,130,127,141,131,124,134,120,129,34.69542709232097,202009
관악로점,1116,906,210,834,282,815,301,103,79,97,106,99,105,107,117,108,90,105,35.026490066225165,202009
관저동로점,1438,1165,273,1075,363,1055,383,126,115,125,127,123,152,135,126,144,121,144,35.33218884120172,202009
광산로점,975,815,160,731,244,716,259,102,91,80,92,77,94,80,92,96,90,81,34.61226993865031,202009
광주여대길점,1203,973,230,881,322,885,318,127,88,99,104,104,120,96,120,96,131,118,34.33299075025694,202009
구덕로점,1178,955,223,875,303,863,315,138,109,107,113,108,93,103,88,119,92,108,47.0586387434555,202009
구청로점,883,726,157,653,230,650,233,94,94,72,74,84,88,77,68,78,76,78,33.743801652892564,202009
국제금융로2점,736,592,144,536,200,540,196,62,68,64,75,59,77,64,58,63,66,80,47.80236486486486,202009
국제금융로점,1345,1091,254,994,351,987,358,138,126,137,132,83,109,122,129,121,118,130,34.901008249312554,202009
금송로점,1269,1049,220,929,340,930,339,127,112,104,117,116,120,102,121,126,108,116,33.93422306959008,202009
금화로점,1291,1043,248,959,332,948,343,123,127,102,130,90,122,138,124,121,106,108,34.922339405560884,202009
기장대로점,1440,1183,257,1082,358,1055,385,135,147,133,122,118,129,135,128,135,135,123,34.204564666103124,202009
기흥점,1060,855,205,786,274,773,287,95,93,75,116,105,99,86,101,85,96,109,34.107602339181284,202009
낙동대로2점,1440,1180,260,1062,378,1057,383,139,115,138,134,125,123,133,129,137,142,125,34.622033898305084,202009
낙동대로점,1209,968,241,897,312,885,324,119,106,100,118,107,109,113,116,104,110,107,34.125,202009
낙동북로점,1110,897,213,809,301,814,296,105,98,94,110,94,105,112,94,96,96,106,35.80490523968785,202009
남동남로점,1347,1101,246,1012,335,988,359,116,128,107,126,134,134,120,133,109,115,125,34.79019073569482,202009
남부순환로2점,1499,1226,273,1107,392,1098,401,145,150,129,134,124,134,135,127,142,151,128,34.939641109298535,202009
남부순환로점,1201,1002,199,901,300,877,324,114,116,99,107,96,107,101,128,102,112,119,34.83433133732535,202009
남천동로점,971,774,197,696,275,714,257,88,87,71,86,88,107,80,87,98,73,106,34.30361757105943,202009
내방로점,1326,1106,220,985,341,973,353,107,129,118,126,104,142,100,101,117,134,148,20.11121157323689,202009
노해로2점,1618,1307,311,1177,441,1186,432,162,147,146,147,159,145,135,139,138,162,138,34.152257077276204,202009
노해로점,1174,967,207,858,316,864,310,118,82,100,117,115,116,102,99,95,118,112,33.68459152016546,202009
녹사평대로2점,1531,1240,291,1127,404,1124,407,135,134,128,165,138,146,147,130,131,145,132,34.19193548387097,202009
녹사평대로점,1352,1133,219,992,360,991,361,119,113,129,131,127,117,122,101,141,135,117,34.54015887025596,202009
다대동로점,1416,1157,259,1079,337,1036,380,153,131,123,125,133,129,129,119,118,122,134,34.29040622299049,202009
달맞이길점,1323,1076,247,1011,312,970,353,135,112,117,100,120,144,116,123,110,124,122,34.81505576208178,202009
당산로2점,1349,1085,264,992,357,990,359,120,140,134,124,117,110,124,115,113,148,104,34.799078341013825,202009
당산로점,1061,898,163,774,287,777,284,100,86,83,95,111,89,85,114,99,98,101,48.99331848552338,202009
대둔산로점,1448,1192,256,1072,376,1060,388,131,143,126,134,135,125,132,121,137,143,121,33.80453020134228,202009
대전로점,1141,926,215,871,270,838,303,94,101,111,108,117,95,105,99,99,102,110,47.36393088552916,202009
대종로점,1472,1191,281,1081,391,1080,392,118,138,134,137,130,130,125,141,134,138,147,35.36943744752309,202009
대흥로점,812,677,135,607,205,595,217,78,78,70,69,76,68,85,72,68,71,77,34.93057607090103,202009
덕남길점,1290,1061,229,938,352,946,344,105,118,113,139,124,127,112,115,118,108,111,34.73044297832234,202009
덕수궁길2점,1174,965,209,854,320,862,312,99,111,94,108,116,99,123,123,102,98,101,34.06321243523316,202009
덕수궁길점,1004,816,188,730,274,741,263,75,89,92,76,92,96,101,96,85,100,102,35.10171568627451,202009
도봉로2점,934,785,149,676,258,686,248,76,72,102,98,79,77,84,95,88,80,83,48.91847133757962,202009
도봉로점,1263,1047,216,902,361,924,339,114,116,117,113,117,119,104,120,126,102,115,34.54727793696275,202009
동구청로점,1289,1057,232,953,336,945,344,122,127,108,131,112,111,117,122,108,105,126,35.102175969725636,202009
둔산로점,1090,893,197,792,298,797,293,125,75,98,101,103,97,105,103,75,102,106,19.967525195968644,202009
둔산서로점,1148,929,219,844,304,842,306,103,114,96,107,122,104,99,98,104,97,104,35.14101184068891,202009
둔산중로점,1091,895,196,805,286,800,291,107,95,118,115,78,84,87,112,105,102,88,35.68491620111732,202009
르노삼성대로점,1064,884,180,805,259,780,284,104,87,97,90,100,77,99,110,94,88,118,34.789592760180994,202009
마들로2점,1031,851,180,758,273,757,274,74,99,89,95,106,99,90,94,92,92,101,34.60399529964747,202009
마들로점,1436,1173,263,1025,411,1055,381,125,147,136,128,138,124,136,125,154,115,108,34.50639386189258,202009
마린시티1로점,908,753,155,666,242,666,242,85,81,70,86,78,92,72,85,83,79,97,33.49269588313413,202009
마포대로2점,1331,1100,231,961,370,975,356,121,101,123,127,136,119,125,123,126,124,106,34.01090909090909,202009
마포대로점,1375,1120,255,1025,350,1005,370,140,114,135,147,135,106,123,98,102,115,160,35.23303571428571,202009
망양로점,1318,1084,234,984,334,967,351,124,127,131,128,113,120,105,111,122,117,120,34.33487084870849,202009
명지국제7로점,1153,952,201,838,315,843,310,108,88,108,103,102,100,105,107,104,110,118,34.82878151260504,202009
명지동점,1259,1013,246,903,356,921,338,106,115,122,117,104,108,119,133,107,117,111,34.34057255676209,202009
명지새동네길점,1145,937,208,856,289,842,303,94,99,113,118,112,104,122,98,94,111,80,33.71077908217716,202009
목공동로2점,1441,1163,278,1079,362,1059,382,135,125,133,111,142,122,111,136,137,156,133,34.496990541702495,202009
목공동로점,1143,940,203,854,289,841,302,106,106,103,122,101,106,91,103,100,102,103,47.29468085106383,202009
못골로점,1083,881,202,785,298,794,289,88,100,97,86,81,89,115,109,110,103,105,34.51872871736663,202009
무교로2점,1528,1286,242,1136,392,1121,407,157,124,163,125,149,123,117,141,138,157,134,34.451788491446344,202009
무교로점,860,703,157,612,248,630,230,78,71,83,69,79,99,85,69,77,80,70,34.253200568990046,202009
문예회관길점,1170,962,208,860,310,857,313,88,95,121,102,115,108,100,108,94,104,135,20.276507276507278,202009
민락수변로점,1261,1040,221,909,352,926,335,111,122,118,116,115,135,124,105,95,109,111,34.20480769230769,202009
방죽로점,1210,975,235,882,328,887,323,86,117,96,103,102,115,91,113,116,136,135,34.90974358974359,202009
배재로점,1465,1188,277,1062,403,1075,390,130,144,127,119,113,151,139,123,136,132,151,34.10942760942761,202009
법원로2점,1292,1083,209,992,300,946,346,111,132,121,114,119,122,110,119,99,113,132,34.499538319482916,202009
법원로점,2237,1816,421,1655,582,1633,604,205,211,189,230,207,188,195,212,201,204,195,34.15638766519824,202009
보문로2점,1055,862,193,776,279,777,278,108,88,84,94,88,93,107,98,106,110,79,34.16125290023202,202009
보문로점,1151,936,215,853,298,841,310,101,105,110,113,92,107,102,102,88,110,121,34.82905982905983,202009
복수서로점,882,719,163,651,231,645,237,79,91,89,82,80,80,76,73,82,72,78,34.65785813630042,202009
봉선로점,1145,951,194,847,298,838,307,96,95,95,104,116,110,113,103,95,120,98,35.110410094637224,202009
봉화산로2점,968,789,179,738,230,716,252,84,84,84,80,93,101,84,86,92,87,93,35.06463878326996,202009
봉화산로점,791,672,119,558,233,579,212,80,81,76,79,45,79,67,76,76,64,68,33.970238095238095,202009
부흥로점,1327,1118,209,1033,294,971,356,142,105,117,121,113,112,128,140,127,115,107,34.44275491949911,202009
북유성대로점,1255,1017,238,925,330,921,334,121,118,125,137,108,106,91,123,101,115,110,34.76401179941003,202009
분포로점,1489,1234,255,1099,390,1096,393,128,141,141,135,127,136,124,134,139,124,160,34.82009724473258,202009
비아로점,1499,1236,263,1126,373,1096,403,118,138,138,135,147,143,130,149,136,127,138,34.782362459546924,202009
사우중로점,1585,1302,283,1183,402,1162,423,145,148,156,152,141,144,141,159,145,131,123,34.12980030721966,202009
사직로2점,1001,803,198,760,241,732,269,104,86,97,73,100,94,89,98,68,112,80,35.083437110834375,202009
사직로점,2272,1882,390,1736,536,1664,608,229,185,200,208,186,208,217,203,221,188,227,34.264612114771516,202009
삼봉로2점,1320,1067,253,1006,314,969,351,126,99,128,128,133,119,102,125,137,121,102,34.64386129334583,202009
삼봉로점,990,786,204,726,264,725,265,88,102,90,94,90,80,117,80,78,78,93,33.7557251908397,202009
삼일대로2점,971,808,163,730,241,711,260,83,105,97,74,74,95,94,81,104,68,96,35.351485148514854,202009
삼일대로점,1171,950,221,848,323,861,310,115,107,94,104,91,98,118,119,109,93,123,34.66842105263158,202009
상무공원로점,1388,1124,264,1004,384,1015,373,116,125,106,147,113,111,134,139,121,147,129,34.67526690391459,202009
상무대로점,1089,903,186,824,265,799,290,92,89,100,111,83,86,103,78,115,120,112,33.69988925802879,202009
상무번영로점,874,708,166,655,219,643,231,79,74,69,67,79,79,83,84,98,78,84,48.08050847457627,202009
서남로점,1089,884,205,819,270,796,293,90,100,107,90,98,104,100,108,104,89,99,33.955882352941174,202009
서소문로2점,1005,838,167,745,260,735,270,89,103,87,94,91,84,83,84,102,89,99,34.643198090692124,202009
서소문로점,1238,1009,229,906,332,904,334,115,124,99,119,123,121,126,103,94,93,121,34.02775024777007,202009
서초중앙로2점,1206,982,224,881,325,885,321,112,112,113,100,115,101,92,113,108,121,119,34.10794297352342,202009
서초중앙로3점,1056,866,190,782,274,775,281,94,86,94,102,91,90,94,106,108,111,80,35.1189376443418,202009
서초중앙로점,1125,920,205,839,286,825,300,106,81,103,90,88,104,95,134,99,113,112,33.80543478260869,202009
서하로점,1502,1260,242,1114,388,1100,402,136,155,123,143,138,146,131,128,136,130,136,33.94761904761905,202009
석봉로점,818,646,172,593,225,600,218,70,63,70,74,77,64,91,79,77,86,67,35.22910216718266,202009
성남대로점,1499,1228,271,1123,376,1102,397,127,139,141,148,155,119,143,121,137,133,136,33.97068403908795,202009
성내로2점,1267,1023,244,924,343,926,341,133,107,108,119,121,124,110,123,112,118,92,35.58162267839687,202009
성내로점,941,761,180,687,254,689,252,70,97,83,84,86,80,79,95,104,78,85,46.563731931668855,202009
성산동2점,1318,1078,240,966,352,971,347,114,121,139,129,103,127,110,117,120,134,104,34.26808905380334,202009
성산동점,1002,807,195,721,281,733,269,98,81,87,85,88,89,90,88,105,90,101,20.158612143742257,202009
세종대로2점,1029,838,191,759,270,752,277,100,87,92,101,78,96,91,112,97,84,91,34.014319809069214,202009
세종대로점,1150,932,218,855,295,842,308,108,97,81,114,114,112,102,113,110,96,103,34.0912017167382,202009
세종로점,1143,928,215,851,292,838,305,124,97,98,121,95,102,102,98,106,103,97,34.79525862068966,202009
송정공원로점,882,721,161,635,247,646,236,79,78,78,78,83,76,69,79,89,86,87,34.610263522884885,202009
송정해변로점,1535,1278,257,1089,446,1124,411,136,149,140,138,149,125,153,140,137,138,130,20.290297339593113,202009
시흥대로2점,967,790,177,705,262,707,260,94,93,101,67,84,77,103,91,99,88,70,34.870886075949365,202009
시흥대로점,1205,956,249,883,322,883,322,107,119,115,107,99,101,108,122,119,109,99,34.20083682008368,202009
신갈마로점,1142,951,191,840,302,840,302,109,118,100,108,104,103,96,116,96,104,88,35.05993690851735,202009
신일동로점,1327,1107,220,978,349,971,356,126,137,111,116,124,115,110,100,119,144,125,34.32610659439928,202009
신일서로점,1235,995,240,931,304,905,330,117,115,108,120,104,100,118,109,123,112,109,34.46834170854272,202009
안양천로2점,1125,930,195,818,307,825,300,88,91,105,112,107,96,109,100,101,102,114,34.66774193548387,202009
안양천로점,1171,945,226,852,319,859,312,127,92,123,98,118,99,110,97,112,94,101,34.73756613756614,202009
양재2점,1268,1052,216,922,346,929,339,136,108,111,118,106,132,116,113,107,111,110,35.346007604562736,202009
양재점,1178,967,211,854,324,861,317,105,101,104,113,133,108,104,118,96,105,91,34.378490175801446,202009
어등대로점,1176,973,203,860,316,860,316,99,121,113,103,89,101,102,112,92,123,121,34.20349434737924,202009
엑스포로점,1082,890,192,795,287,790,292,97,97,93,96,108,92,109,89,98,102,101,34.46067415730337,202009
연제로점,1385,1142,243,1065,320,1014,371,115,130,130,125,129,138,144,91,119,134,130,33.774080560420316,202009
연희로2점,1377,1101,276,1006,371,1009,368,124,117,112,144,116,136,131,122,124,134,117,34.18801089918256,202009
연희로점,1057,849,208,800,257,775,282,106,99,111,83,76,100,87,91,91,108,105,34.1283863368669,202009
영통구점,1061,874,187,805,256,778,283,81,103,92,92,96,97,98,97,93,111,101,34.74256292906178,202009
예술길점,1150,920,230,866,284,844,306,113,133,100,106,95,94,108,99,87,102,113,34.18369565217391,202009
온천천로점,1530,1234,296,1113,417,1123,407,156,139,141,124,148,134,124,138,138,137,151,34.615072933549435,202009
올림픽로2점,1352,1103,249,1006,346,991,361,136,106,121,120,128,117,109,143,120,106,146,19.890299184043517,202009
올림픽로점,972,786,186,731,241,715,257,86,97,86,96,110,78,97,90,85,74,73,34.166666666666664,202009
용대로점,1027,819,208,753,274,755,272,78,90,94,94,91,91,108,89,76,110,106,34.12698412698413,202009
용아로점,1316,1070,246,981,335,963,353,116,137,132,132,119,107,120,136,104,100,113,34.769158878504676,202009
용운동점,852,685,167,653,199,624,228,85,66,78,82,71,95,72,83,66,82,72,33.833576642335764,202009
우치로점,1121,905,216,814,307,823,298,99,90,113,111,91,106,103,96,105,103,104,47.58342541436464,202009
월계로2점,997,810,187,731,266,728,269,82,94,92,88,87,87,92,99,95,93,88,33.592592592592595,202009
월계로점,1203,982,221,882,321,887,316,104,98,116,102,89,102,115,137,112,113,115,19.887983706720977,202009
월드컵대로2점,884,710,174,643,241,649,235,77,77,83,85,63,79,96,82,82,85,75,33.98028169014084,202009
월드컵대로점,1113,889,224,829,284,815,298,115,97,93,98,79,111,93,123,93,108,103,34.006749156355454,202009
월드컵로2점,1387,1132,255,1045,342,1018,369,126,136,127,123,119,125,118,125,138,117,133,34.041519434628974,202009
월드컵로점,914,737,177,705,209,671,243,102,103,78,87,91,67,74,79,81,79,73,34.846675712347356,202009
은평로2점,855,696,159,632,223,626,229,68,70,80,85,82,87,74,72,68,91,78,34.53735632183908,202009
은평로점,1200,990,210,878,322,882,318,113,113,97,96,109,126,111,116,118,95,106,34.68787878787879,202009
일산동구점,1112,904,208,813,299,814,298,96,103,98,96,120,102,107,97,97,96,100,34.61283185840708,202009
자양로2점,1049,866,183,764,285,772,277,101,110,94,108,102,91,79,96,85,93,90,33.86027713625866,202009
자양로점,1139,920,219,851,288,833,306,122,98,98,104,96,101,97,113,98,116,96,33.97717391304348,202009
장대로점,1208,1005,203,875,333,887,321,102,101,120,124,98,77,111,111,123,117,124,34.0318407960199,202009
장동로점,966,792,174,723,243,710,256,103,69,84,71,96,90,87,91,94,88,93,35.061868686868685,202009
장승배기로2점,1150,936,214,841,309,840,310,100,104,120,102,99,105,79,140,96,102,103,34.37713675213675,202009
장승배기로점,1115,932,183,797,318,819,296,103,96,104,100,121,98,110,103,96,88,96,20.452789699570815,202009
재반로점,1209,969,240,875,334,885,324,123,121,106,112,125,100,131,88,114,90,99,33.91228070175438,202009
절영로점,1435,1164,271,1072,363,1051,384,129,141,136,144,125,137,143,113,133,126,108,33.79037800687285,202009
절재로점,1362,1105,257,1022,340,1002,360,122,144,110,123,122,116,113,119,135,127,131,34.753846153846155,202009
제중로점,1147,910,237,848,299,841,306,96,127,86,110,90,106,109,108,107,106,102,33.808791208791206,202009
조치원점,1146,925,221,843,303,842,304,118,93,108,94,108,97,115,113,105,96,99,34.47675675675676,202009
종로2점,1501,1235,266,1138,363,1100,401,144,104,149,141,129,133,141,148,141,138,133,34.95465587044534,202009
종로점,1057,840,217,778,279,773,284,104,98,82,93,111,88,97,100,73,104,107,33.9,202009
준법로점,1118,920,198,827,291,821,297,105,108,98,107,105,99,109,101,86,115,85,35.39782608695652,202009
중구로점,1445,1185,260,1085,360,1056,389,129,116,111,141,124,144,134,149,127,142,128,34.10886075949367,202009
중동2로점,698,567,131,530,168,514,184,76,62,41,72,58,70,60,57,65,71,66,34.139329805996475,202009
중앙대로2점,1347,1092,255,966,381,987,360,124,128,107,123,106,137,137,127,117,124,117,34.0503663003663,202009
중앙대로점,2168,1756,412,1655,513,1588,580,213,183,200,214,200,182,204,199,175,191,207,34.58200455580866,202009
증심사길점,1266,1030,236,936,330,927,339,103,102,113,101,142,116,119,114,119,123,114,34.231067961165046,202009
창경궁로2점,1401,1140,261,1055,346,1026,375,116,139,120,129,135,108,148,127,103,142,134,34.60526315789474,202009
창경궁로점,1232,1002,230,898,334,905,327,93,109,116,108,102,126,114,121,118,110,115,35.05988023952096,202009
처인구점,1004,817,187,725,279,737,267,92,95,93,86,86,89,87,97,87,107,85,34.578947368421055,202009
천호대로2점,1531,1259,272,1130,401,1128,403,129,143,147,153,154,138,135,132,131,137,132,34.79030976965846,202009
천호대로점,976,782,194,746,230,715,261,93,108,77,75,77,86,85,98,81,100,96,34.79156010230179,202009
첨단과기로점,1289,1056,233,983,306,943,346,103,121,113,119,125,102,119,124,122,123,118,34.714962121212125,202009
청계청로2점,1311,1047,264,981,330,962,349,125,124,121,111,122,127,110,136,108,120,107,34.10792741165234,202009
청계청로점,880,725,155,673,207,644,236,69,77,91,82,81,87,81,73,79,77,83,34.30206896551724,202009
청사포로점,1233,988,245,905,328,904,329,112,101,106,107,108,122,117,114,110,121,115,20.555668016194332,202009
태종로점,1146,925,221,826,320,841,305,119,121,104,88,104,89,113,111,102,104,91,34.43351351351351,202009
필문대로점,1150,944,206,838,312,841,309,100,89,119,123,100,89,99,94,121,98,118,34.748940677966104,202009
하남산단점,1004,809,195,727,277,735,269,92,96,91,97,93,96,99,85,81,84,90,34.42150803461063,202009
하리해안길점,1119,901,218,821,298,821,298,114,106,86,120,102,97,100,100,111,87,96,34.2708102108768,202009
하신번영로점,1471,1219,252,1062,409,1079,392,125,155,119,132,138,112,125,129,136,144,156,35.52912223133716,202009
하신중앙로점,1203,972,231,913,290,885,318,126,118,110,110,108,97,108,88,111,119,108,34.02674897119341,202009
학감대로점,1384,1146,238,1043,341,1017,367,123,133,132,132,119,145,118,136,124,127,95,35.196335078534034,202009
학동로2점,1414,1147,267,1082,332,1040,374,112,136,143,129,147,139,149,106,117,109,127,34.55013077593723,202009
학동로점,1386,1126,260,1029,357,1018,368,135,132,105,122,111,114,129,139,135,132,132,34.5968028419183,202009
한남로점,996,826,170,759,237,731,265,74,88,110,83,98,88,90,94,102,73,96,34.77481840193705,202009
한누리대로점,1254,1023,231,929,325,919,335,114,108,137,115,113,95,122,109,120,102,119,33.93352883675464,202009
한밭대로점,1060,868,192,770,290,778,282,114,98,98,97,90,79,96,88,95,105,100,48.1463133640553,202009
해안새벽시장길점,1204,996,208,876,328,881,323,113,100,111,105,103,100,108,112,123,109,120,34.380522088353416,202009
해운대로점,1375,1149,226,1021,354,1008,367,140,133,133,136,119,135,108,111,113,115,132,34.28981723237598,202009
해운대해변로점,1001,827,174,733,268,732,269,93,87,95,92,104,103,88,93,87,82,77,19.96130592503023,202009
화곡로2점,1168,949,219,861,307,859,309,95,92,119,123,107,93,122,102,116,95,104,34.71232876712329,202009
화곡로점,1063,863,200,772,291,779,284,114,99,82,92,89,94,96,89,96,96,116,34.16801853997683,202009
화중로점,1144,926,218,811,333,838,306,106,105,102,123,115,106,111,98,81,94,103,33.47300215982721,202009
효덕로점,1300,1046,254,951,349,951,349,129,135,114,113,107,117,140,119,118,113,95,34.51625239005736,202009
효원로점,789,658,131,572,217,575,214,61,83,63,75,72,73,61,81,67,69,84,34.31306990881459,202009
가덕해안로점,1028,839,189,775,253,729,299,91,100,97,85,84,104,95,101,88,99,84,34.794994040524436,202010
가마산로2점,1519,1237,282,1141,378,1078,441,140,137,143,139,148,142,136,137,129,135,133,34.75828617623282,202010
가마산로점,1062,842,220,771,291,758,304,121,88,100,100,81,96,102,88,89,108,89,35.19952494061758,202010
감천항로점,1036,840,196,756,280,734,302,98,82,100,104,107,83,94,101,91,79,97,33.86190476190476,202010
강남대로2점,1130,938,192,867,263,800,330,99,93,110,110,116,99,105,110,85,96,107,34.94243070362474,202010
강남대로점,1090,904,186,802,288,772,318,91,91,92,115,97,90,106,89,109,117,93,34.158185840707965,202010
강남점3점,1315,1076,239,977,338,932,383,111,104,109,103,140,137,119,122,111,115,144,34.74814126394052,202010
경열로점,1188,958,230,883,305,842,346,100,120,101,109,103,108,105,104,112,113,113,34.291231732776616,202010
계룡로점,1428,1167,261,1045,383,1012,416,122,130,136,138,136,124,121,126,136,124,135,34.18594687232219,202010
계족로점,1186,973,213,889,297,841,345,112,95,105,117,122,121,113,98,98,111,94,34.701952723535456,202010
고산자로2점,1434,1158,276,1051,383,1016,418,115,130,120,134,138,119,148,141,118,129,142,35.545768566493955,202010
고산자로점,1068,864,204,789,279,759,309,86,115,80,83,108,94,94,106,98,101,103,33.67824074074074,202010
관악로2점,1460,1170,290,1090,370,1037,423,145,130,144,133,125,141,122,128,129,134,129,35.67094017094017,202010
관악로점,1150,948,202,839,311,817,333,103,88,107,111,97,105,123,106,102,112,96,35.222573839662445,202010
관저동로점,1494,1204,290,1132,362,1060,434,124,131,135,131,131,137,148,129,138,130,160,34.69019933554817,202010
광산로점,1001,807,194,745,256,711,290,109,85,86,98,96,92,74,85,107,87,82,34.53531598513011,202010
광주여대길점,1252,1020,232,948,304,890,362,118,121,112,128,122,99,112,112,112,109,107,34.318627450980394,202010
구덕로점,1215,1009,206,902,313,862,353,111,104,114,107,97,109,108,111,116,121,117,47.66699702675917,202010
구청로점,914,748,166,661,253,649,265,89,79,65,116,85,81,77,80,71,79,92,34.8168449197861,202010
국제금융로2점,755,619,136,557,198,534,221,70,73,79,68,70,63,66,64,73,62,67,46.058158319870756,202010
국제금융로점,1394,1147,247,1037,357,985,409,126,131,137,130,139,115,138,139,110,107,122,34.58936355710549,202010
금송로점,1312,1079,233,968,344,933,379,116,121,111,118,104,126,113,122,119,128,134,34.136237256719184,202010
금화로점,1332,1109,223,974,358,945,387,126,115,134,118,107,123,127,111,126,122,123,35.01532912533814,202010
기장대로점,1491,1209,282,1094,397,1061,430,134,132,131,134,143,132,128,154,133,140,130,34.240694789081886,202010
기흥점,1096,893,203,822,274,776,320,101,75,95,92,104,91,125,117,97,94,105,35.23068309070549,202010
낙동대로2점,1492,1205,287,1084,408,1063,429,141,143,145,134,133,144,129,120,149,130,124,35.12116182572614,202010
낙동대로점,1240,1002,238,912,328,877,363,99,115,98,97,132,114,95,123,126,112,129,34.612774451097806,202010
낙동북로점,1152,928,224,853,299,816,336,113,98,91,90,109,105,112,116,93,110,115,34.713362068965516,202010
남동남로점,1404,1161,243,1040,364,1002,402,124,132,139,144,133,124,119,124,113,140,112,33.81567614125753,202010
남부순환로2점,1548,1240,308,1140,408,1100,448,154,150,140,164,157,113,136,121,132,139,142,34.806451612903224,202010
남부순환로점,1244,1033,211,939,305,880,364,95,127,116,111,137,110,101,121,106,109,111,34.94094869312681,202010
남천동로점,1004,806,198,746,258,712,292,100,112,84,91,95,65,117,82,95,78,85,35.29652605459057,202010
내방로점,1365,1106,259,1013,352,971,394,123,128,109,120,130,139,137,132,132,115,100,19.9249547920434,202010
노해로2점,1679,1347,332,1242,437,1195,484,148,174,140,144,154,159,146,180,150,156,128,33.96956198960653,202010
노해로점,1216,1015,201,884,332,869,347,107,102,120,127,125,112,103,111,93,116,100,34.53694581280788,202010
녹사평대로2점,1582,1282,300,1178,404,1122,460,139,125,126,157,166,143,132,162,145,150,137,34.42121684867395,202010
녹사평대로점,1403,1153,250,1043,360,994,409,138,126,117,119,132,116,141,142,142,107,123,34.02775368603643,202010
다대동로점,1455,1186,269,1092,363,1029,426,123,149,126,119,134,127,159,132,138,126,122,34.1787521079258,202010
달맞이길점,1363,1104,259,1029,334,964,399,122,126,115,108,116,121,122,132,144,130,127,33.291666666666664,202010
당산로2점,1405,1155,250,1008,397,997,408,148,121,126,134,105,123,134,127,133,121,133,34.622510822510826,202010
당산로점,1085,892,193,804,281,767,318,100,93,100,111,94,96,108,97,94,93,99,48.00560538116592,202010
대둔산로점,1481,1212,269,1090,391,1053,428,127,132,137,141,131,128,142,139,122,145,137,34.613036303630366,202010
대전로점,1186,982,204,884,302,840,346,118,106,116,119,106,91,102,112,111,104,101,47.026476578411405,202010
대종로점,1525,1261,264,1129,396,1084,441,114,139,135,133,133,130,158,142,149,138,154,34.56383822363204,202010
대흥로점,843,679,164,613,230,599,244,66,80,62,72,75,77,75,86,92,86,72,35.06332842415317,202010
덕남길점,1339,1067,272,982,357,955,384,124,94,134,133,127,126,127,128,101,114,131,34.12652296157451,202010
덕수궁길2점,1216,1002,214,887,329,864,352,126,113,104,111,111,122,116,105,93,101,114,33.87624750499002,202010
덕수궁길점,1031,829,202,768,263,729,302,100,79,108,73,98,89,99,86,95,99,105,35.05548854041013,202010
도봉로2점,966,788,178,714,252,686,280,98,91,96,86,91,91,100,88,81,83,61,46.17766497461929,202010
도봉로점,1297,1074,223,957,340,923,374,131,122,117,118,118,122,119,113,92,123,122,34.38081936685288,202010
동구청로점,1342,1100,242,1001,341,950,392,109,128,125,130,148,129,109,110,109,128,117,34.60909090909091,202010
둔산로점,1126,916,210,849,277,801,325,118,92,109,98,88,103,110,103,86,125,94,20.391921397379914,202010
둔산서로점,1179,972,207,855,324,838,341,111,119,111,105,115,88,100,111,99,106,114,34.31687242798354,202010
둔산중로점,1132,930,202,853,279,805,327,111,117,103,96,102,122,106,96,77,101,101,34.116129032258065,202010
르노삼성대로점,1101,919,182,814,287,782,319,115,91,118,104,101,86,93,100,77,93,123,35.32426550598477,202010
마들로2점,1053,877,176,788,265,749,304,105,109,104,92,90,88,100,87,97,89,92,34.826681870011406,202010
마들로점,1490,1207,283,1100,390,1057,433,125,147,123,122,147,155,142,120,140,127,142,33.986743993371995,202010
마린시티1로점,945,777,168,706,239,670,275,90,76,79,85,97,78,93,77,99,74,97,34.55083655083655,202010
마포대로2점,1361,1115,246,1005,356,966,395,112,121,113,119,133,120,139,141,126,129,108,34.25829596412556,202010
마포대로점,1432,1168,264,1070,362,1015,417,137,136,139,127,121,121,116,138,140,131,126,34.13527397260274,202010
망양로점,1377,1110,267,1016,361,976,401,106,111,124,143,148,124,138,122,120,114,127,34.54144144144144,202010
명지국제7로점,1186,998,188,863,323,840,346,101,99,122,100,91,108,125,124,107,106,103,33.49599198396793,202010
명지동점,1308,1063,245,977,331,926,382,113,121,133,117,113,134,102,105,128,109,133,35.055503292568204,202010
명지새동네길점,1183,987,196,908,275,837,346,112,96,88,103,124,114,100,120,110,105,111,35.01013171225937,202010
목공동로2점,1497,1233,264,1078,419,1060,437,148,126,145,133,140,144,148,121,130,126,136,34.48337388483374,202010
목공동로점,1186,989,197,877,309,837,349,109,117,124,112,109,106,97,95,118,119,80,48.322548028311424,202010
못골로점,1123,890,233,826,297,797,326,111,117,85,94,97,114,99,114,112,97,83,34.67191011235955,202010
무교로2점,1578,1286,292,1163,415,1123,455,121,129,156,150,146,141,137,141,148,169,140,34.11741835147745,202010
무교로점,881,716,165,669,212,623,258,82,83,92,71,72,71,85,72,104,74,75,33.944134078212294,202010
문예회관길점,1208,965,243,905,303,856,352,95,118,115,120,119,112,115,90,113,108,103,20.13160621761658,202010
민락수변로점,1310,1052,258,979,331,934,376,125,128,114,123,139,108,111,116,105,121,120,34.5712927756654,202010
방죽로점,1237,1022,215,909,328,881,356,105,120,108,97,119,110,109,114,118,118,119,34.83757338551859,202010
배재로점,1521,1230,291,1109,412,1081,440,136,141,152,134,137,120,136,141,147,147,130,34.59268292682927,202010
법원로2점,1336,1064,272,976,360,948,388,110,100,139,117,136,102,112,137,123,118,142,34.89661654135338,202010
법원로점,2311,1874,437,1735,576,1638,673,221,215,217,215,229,186,213,216,166,209,224,34.97491995731057,202010
보문로2점,1093,890,203,807,286,775,318,118,96,101,95,101,111,105,96,92,91,87,34.030337078651684,202010
보문로점,1196,948,248,882,314,849,347,118,112,98,121,99,99,124,103,104,118,100,35.39662447257384,202010
복수서로점,906,737,169,694,212,641,265,67,89,86,86,80,73,95,84,77,87,82,33.58480325644505,202010
봉선로점,1190,972,218,895,295,843,347,106,101,106,109,108,112,111,119,116,115,87,34.181069958847736,202010
봉화산로2점,1000,819,181,782,218,707,293,95,87,98,85,88,79,84,101,93,89,101,35.043956043956044,202010
봉화산로점,822,679,143,623,199,580,242,68,70,68,78,75,73,79,69,80,75,87,34.799705449189986,202010
부흥로점,1364,1121,243,1035,329,969,395,123,122,118,134,132,136,115,134,125,111,114,34.324710080285456,202010
북유성대로점,1307,1084,223,942,365,927,380,118,124,110,111,122,114,114,133,119,116,126,33.580258302583026,202010
분포로점,1547,1243,304,1143,404,1095,452,152,161,128,130,131,120,158,125,148,136,158,34.35880933226066,202010
비아로점,1551,1278,273,1172,379,1099,452,135,157,149,128,148,127,153,144,131,154,125,34.45305164319249,202010
사우중로점,1641,1326,315,1241,400,1164,477,150,148,150,140,140,153,157,156,145,155,147,33.957013574660635,202010
사직로2점,1036,841,195,772,264,734,302,91,112,89,84,77,106,107,86,88,88,108,33.92271105826397,202010
사직로점,2337,1875,462,1706,631,1660,677,198,217,209,221,196,210,228,200,222,214,222,34.3312,202010
삼봉로2점,1366,1113,253,1033,333,972,394,130,112,116,119,118,116,140,121,146,125,123,34.37466307277628,202010
삼봉로점,1035,851,184,758,277,735,300,97,89,95,91,87,97,110,85,93,98,93,34.09165687426557,202010
삼일대로2점,998,838,160,744,254,706,292,89,96,96,84,92,93,90,99,88,91,80,34.159904534606206,202010
삼일대로점,1205,987,218,907,298,861,344,102,102,107,103,115,124,101,130,112,109,100,34.69402228976697,202010
상무공원로점,1433,1150,283,1084,349,1018,415,136,132,140,128,108,129,137,122,132,140,129,34.788695652173914,202010
상무대로점,1125,909,216,846,279,800,325,89,110,94,97,103,100,121,101,117,88,105,34.41694169416942,202010
상무번영로점,904,720,184,680,224,641,263,81,78,79,80,80,95,102,85,73,70,81,47.18194444444445,202010
서남로점,1125,921,204,798,327,797,328,109,106,120,93,96,100,100,104,92,108,97,34.14115092290988,202010
서소문로2점,1035,851,184,762,273,736,299,91,78,89,107,99,94,86,84,107,90,110,34.57461809635723,202010
서소문로점,1265,1020,245,942,323,897,368,108,114,122,133,111,121,112,111,101,113,119,34.35098039215686,202010
서초중앙로2점,1254,1017,237,947,307,886,368,125,112,116,99,130,120,96,112,105,128,111,34.05604719764012,202010
서초중앙로3점,1090,873,217,788,302,773,317,98,100,95,116,84,109,100,93,90,96,109,33.553264604811,202010
서초중앙로점,1156,964,192,854,302,818,338,107,101,106,97,113,100,103,108,105,120,96,34.343360995850624,202010
서하로점,1556,1279,277,1159,397,1105,451,150,127,136,168,133,126,167,138,137,151,123,34.342455043002346,202010
석봉로점,855,709,146,629,226,608,247,81,87,78,75,94,70,74,77,69,76,74,34.599435825105786,202010
성남대로점,1561,1282,279,1162,399,1109,452,133,164,123,153,150,153,143,138,133,151,120,34.66926677067082,202010
성내로2점,1307,1053,254,975,332,928,379,108,134,120,110,121,122,116,113,98,139,126,35.01329534662868,202010
성내로점,972,809,163,702,270,687,285,81,99,84,93,84,102,72,73,86,100,98,48.276885043263285,202010
성산동2점,1366,1123,243,1018,348,970,396,126,115,123,121,130,125,120,123,132,119,132,33.70080142475512,202010
성산동점,1027,846,181,783,244,730,297,82,77,100,82,90,115,99,82,102,91,107,20.75177304964539,202010
세종대로2점,1066,884,182,768,298,756,310,102,83,89,86,94,104,112,102,94,95,105,34.821266968325794,202010
세종대로점,1188,971,217,845,343,841,347,112,107,115,106,93,102,96,128,111,115,103,34.535530381050464,202010
세종로점,1173,962,211,877,296,835,338,109,99,101,104,106,114,96,92,140,99,113,34.26923076923077,202010
송정공원로점,902,747,155,651,251,639,263,81,88,83,79,90,72,83,70,87,88,81,35.35609103078983,202010
송정해변로점,1568,1284,284,1142,426,1110,458,155,107,142,143,132,149,141,160,131,154,154,20.26246105919003,202010
시흥대로2점,1001,815,186,756,245,710,291,84,93,93,99,92,84,85,88,87,102,94,35.28834355828221,202010
시흥대로점,1251,1017,234,926,325,886,365,114,97,116,119,114,120,127,103,117,118,106,35.249754178957716,202010
신갈마로점,1187,959,228,881,306,840,347,107,110,111,99,118,111,125,118,106,82,100,34.300312825860274,202010
신일동로점,1369,1138,231,1013,356,969,400,126,116,130,127,126,132,135,131,130,106,110,34.17223198594024,202010
신일서로점,1279,1045,234,963,316,910,369,124,119,108,101,109,123,128,115,137,112,103,34.90813397129187,202010
안양천로2점,1155,950,205,850,305,820,335,116,111,116,109,104,103,109,89,95,94,109,33.996842105263156,202010
안양천로점,1213,972,241,900,313,860,353,122,100,98,109,117,113,122,115,119,90,108,34.6440329218107,202010
양재2점,1302,1071,231,974,328,926,376,120,122,127,137,106,103,120,117,121,115,114,34.77404295051354,202010
양재점,1214,985,229,919,295,862,352,138,111,94,121,115,100,98,100,96,107,134,34.153299492385784,202010
어등대로점,1212,990,222,903,309,860,352,116,98,101,103,106,98,86,108,116,129,151,34.465656565656566,202010
엑스포로점,1125,924,201,800,325,799,326,102,98,98,102,96,97,106,105,107,106,108,34.06277056277056,202010
연제로점,1421,1142,279,1049,372,1000,421,121,122,127,156,124,121,110,124,131,139,146,34.023642732049034,202010
연희로2점,1433,1186,247,1023,410,1015,418,138,119,118,144,98,142,137,125,133,147,132,34.806913996627316,202010
연희로점,1090,907,183,810,280,772,318,99,95,107,93,96,97,105,95,96,112,95,34.19955898566703,202010
영통구점,1095,891,204,832,263,778,317,97,106,93,97,95,95,109,95,119,98,91,34.29854096520763,202010
예술길점,1192,959,233,907,285,845,347,109,106,97,91,124,126,109,108,115,101,106,34.64754953076121,202010
온천천로점,1584,1283,301,1177,407,1125,459,170,133,145,135,122,162,140,156,132,139,150,34.49883086515978,202010
올림픽로2점,1399,1129,270,1050,349,1000,399,141,122,142,111,117,130,114,118,137,138,129,20.20106288751107,202010
올림픽로점,1009,838,171,755,254,714,295,105,92,92,88,97,93,85,76,105,95,81,35.18019093078759,202010
용대로점,1066,850,216,791,275,756,310,87,98,115,99,90,98,95,106,93,91,94,34.56588235294117,202010
용아로점,1365,1088,277,1046,319,967,398,131,120,124,124,114,125,126,120,127,135,119,34.67922794117647,202010
용운동점,875,694,181,644,231,625,250,74,82,84,85,67,82,95,63,94,74,75,35.15706051873199,202010
우치로점,1152,929,223,864,288,817,335,92,81,120,111,86,127,110,106,108,109,102,47.13455328310011,202010
월계로2점,1027,828,199,775,252,727,300,102,78,106,83,77,89,113,98,86,100,95,34.60507246376812,202010
월계로점,1247,1032,215,935,312,888,359,136,107,109,96,117,112,113,121,101,116,119,20.843023255813954,202010
월드컵대로2점,922,769,153,670,252,655,267,90,79,85,87,91,71,79,84,91,81,84,34.495448634590375,202010
월드컵대로점,1147,940,207,849,298,813,334,114,109,94,89,116,101,97,113,101,104,109,34.44787234042553,202010
월드컵로2점,1428,1174,254,1054,374,1015,413,98,129,129,145,126,146,113,130,134,130,148,34.975298126064736,202010
월드컵로점,946,761,185,701,245,671,275,71,83,111,77,82,73,94,93,91,85,86,33.827858081471746,202010
은평로2점,889,716,173,662,227,629,260,67,85,103,80,76,74,69,88,88,93,66,34.66480446927374,202010
은평로점,1243,1016,227,920,323,880,363,104,96,133,141,113,131,110,88,108,121,98,34.66535433070866,202010
일산동구점,1145,933,212,835,310,816,329,115,112,108,99,121,87,108,96,84,112,103,34.38049303322615,202010
자양로2점,1103,921,182,825,278,783,320,97,116,105,94,113,109,99,102,101,88,79,35.36590662323562,202010
자양로점,1190,954,236,869,321,848,342,99,99,99,98,133,114,92,118,115,110,113,33.82809224318658,202010
장대로점,1246,1034,212,932,314,885,361,121,116,107,119,103,117,102,113,111,113,124,34.4825918762089,202010
장동로점,1000,793,207,756,244,708,292,81,80,90,115,87,93,105,79,92,94,84,35.37074401008827,202010
장승배기로2점,1188,973,215,876,312,841,347,117,101,112,105,86,108,96,110,109,107,137,33.896197327852,202010
장승배기로점,1147,923,224,826,321,815,332,114,98,97,117,109,89,116,123,104,86,94,21.032502708559047,202010
재반로점,1241,990,251,907,334,883,358,102,104,114,103,114,135,103,139,100,113,114,35.027272727272724,202010
절영로점,1492,1203,289,1111,381,1060,432,143,124,129,139,157,128,140,133,147,131,121,33.719866999168744,202010
절재로점,1396,1131,265,1035,361,992,404,115,141,120,111,130,124,125,149,131,117,133,34.95932802829355,202010
제중로점,1177,974,203,874,303,837,340,106,124,112,120,108,98,103,104,101,93,108,34.937371663244356,202010
조치원점,1187,992,195,906,281,848,339,103,94,120,93,110,110,127,106,113,99,112,34.181451612903224,202010
종로2점,1551,1245,306,1142,409,1102,449,134,135,118,138,168,153,129,165,137,124,150,34.37269076305221,202010
종로점,1099,903,196,809,290,784,315,83,100,91,105,110,91,105,105,87,113,109,35.59246954595792,202010
준법로점,1164,912,252,860,304,827,337,104,119,111,106,98,95,113,108,108,94,108,35.36732456140351,202010
중구로점,1491,1217,274,1110,381,1063,428,126,144,149,131,122,151,122,137,150,137,122,34.87099424815119,202010
중동2로점,729,585,144,532,197,515,214,57,64,58,82,62,79,58,66,69,67,67,35.08888888888889,202010
중앙대로2점,1397,1170,227,1019,378,993,404,116,119,136,134,129,135,123,133,112,124,136,33.97008547008547,202010
중앙대로점,2246,1820,426,1646,600,1593,653,194,206,216,205,181,195,206,186,227,206,224,34.5521978021978,202010
증심사길점,1305,1068,237,958,347,926,379,101,121,108,124,110,131,130,110,118,133,119,34.66198501872659,202010
창경궁로2점,1453,1148,305,1085,368,1034,419,129,138,149,126,124,135,104,154,133,129,132,34.613240418118465,202010
창경궁로점,1280,1028,252,948,332,906,374,111,116,128,102,120,125,111,122,125,104,116,34.43385214007782,202010
처인구점,1040,856,184,761,279,738,302,108,83,96,101,107,93,89,99,84,85,95,34.550233644859816,202010
천호대로2점,1578,1256,322,1193,385,1122,456,148,154,143,133,169,140,144,125,142,149,131,34.36863057324841,202010
천호대로점,992,798,194,728,264,702,290,97,99,82,79,87,86,86,100,100,102,74,34.57518796992481,202010
첨단과기로점,1344,1090,254,1004,340,950,394,125,118,118,139,110,112,110,132,134,106,140,34.41284403669725,202010
청계청로2점,1371,1142,229,1010,361,973,398,135,138,126,125,120,119,121,130,117,118,122,34.77145359019264,202010
청계청로점,911,730,181,675,236,648,263,85,77,84,75,86,98,75,76,84,89,82,34.97260273972603,202010
청사포로점,1270,1024,246,965,305,897,373,114,112,109,111,99,121,117,126,128,126,107,20.326171875,202010
태종로점,1191,981,210,866,325,847,344,108,107,95,121,97,117,103,107,125,95,116,35.01019367991845,202010
필문대로점,1185,954,231,905,280,840,345,109,94,110,113,90,122,111,108,113,103,112,34.4832285115304,202010
하남산단점,1041,846,195,765,276,741,300,104,88,92,95,81,86,94,98,108,93,102,34.797872340425535,202010
하리해안길점,1151,951,200,848,303,818,333,123,109,103,110,103,100,114,101,93,93,102,34.198738170347006,202010
하신번영로점,1523,1280,243,1144,379,1080,443,144,156,145,140,147,130,141,139,122,130,129,34.46796875,202010
하신중앙로점,1240,1014,226,919,321,876,364,116,99,104,109,120,107,130,107,121,120,107,34.99605522682446,202010
학감대로점,1434,1168,266,1016,418,1021,413,129,128,121,127,121,141,152,140,134,113,128,33.778253424657535,202010
학동로2점,1454,1213,241,1065,389,1034,420,135,134,137,124,145,132,114,118,144,133,138,34.63726298433635,202010
학동로점,1430,1168,262,1083,347,1016,414,114,125,143,127,142,138,111,136,162,112,120,34.14041095890411,202010
한남로점,1029,823,206,774,255,730,299,85,83,91,96,98,101,97,88,86,97,107,34.36573511543135,202010
한누리대로점,1303,1068,235,971,332,925,378,127,118,132,94,125,102,125,138,99,115,128,34.77340823970037,202010
한밭대로점,1087,891,196,797,290,771,316,101,105,97,106,107,101,93,81,93,107,96,48.00224466891134,202010
해안새벽시장길점,1244,1013,231,913,331,879,365,92,137,121,81,113,113,115,106,135,111,120,34.59427443237907,202010
해운대로점,1421,1170,251,1040,381,1005,416,137,134,108,131,118,134,125,116,149,137,132,34.483760683760686,202010
해운대해변로점,1019,835,184,765,254,722,297,84,90,114,91,85,101,84,92,91,105,82,20.47065868263473,202010
화곡로2점,1220,987,233,904,316,866,354,122,126,100,97,97,116,113,105,118,119,107,35.151975683890576,202010
화곡로점,1097,886,211,825,272,778,319,107,82,94,114,97,86,106,110,98,110,93,33.809255079006775,202010
화중로점,1189,953,236,892,297,839,350,122,97,107,116,121,100,105,103,115,101,102,34.90556138509969,202010
효덕로점,1323,1081,242,994,329,938,385,124,123,94,120,126,124,112,117,129,114,140,33.45975948196115,202010
효원로점,817,673,144,615,202,581,236,73,84,69,73,73,80,69,85,68,83,60,34.341753343239226,202010
가덕해안로점,1001,824,177,751,250,698,303,93,112,76,101,90,80,81,79,96,93,100,33.74029126213592,202011
가마산로2점,1450,1206,244,1082,368,1020,430,129,138,112,116,149,141,146,136,116,129,138,34.84908789386402,202011
가마산로점,1032,834,198,775,257,721,311,113,85,91,81,73,94,101,93,124,91,86,34.94724220623501,202011
감천항로점,997,809,188,730,267,698,299,86,92,94,85,97,87,85,95,97,89,90,33.784919653893695,202011
강남대로2점,1086,888,198,786,300,762,324,98,90,102,98,102,97,99,102,83,99,116,35.023648648648646,202011
강남대로점,1055,879,176,778,277,738,317,99,76,98,88,92,99,102,76,107,100,118,34.821387940841866,202011
강남점3점,1255,1032,223,910,345,876,379,131,107,109,110,123,87,128,107,108,115,130,35.08139534883721,202011
경열로점,1143,935,208,848,295,798,345,105,102,105,100,99,119,108,115,84,105,101,34.677005347593585,202011
계룡로점,1374,1112,262,990,384,964,410,124,129,149,129,114,95,112,143,127,121,131,34.55395683453237,202011
계족로점,1138,939,199,856,282,796,342,98,105,79,117,87,97,125,99,118,109,104,34.7454739084132,202011
고산자로2점,1369,1122,247,1022,347,965,404,121,135,122,114,105,136,134,124,106,140,132,35.00623885918004,202011
고산자로점,1022,836,186,755,267,713,309,104,100,75,104,90,89,93,89,95,84,99,35.27392344497608,202011
관악로2점,1408,1166,242,1043,365,981,427,145,136,143,109,130,120,136,103,144,120,122,34.23327615780446,202011
관악로점,1117,914,203,826,291,783,334,105,103,107,92,103,85,99,116,113,109,85,34.41247264770241,202011
관저동로점,1437,1172,265,1079,358,1007,430,141,122,120,135,119,142,125,138,127,144,124,34.505972696245735,202011
광산로점,962,784,178,724,238,675,287,96,86,91,79,94,71,78,108,84,86,89,34.817602040816325,202011
광주여대길점,1204,955,249,861,343,840,364,114,126,71,115,107,101,108,121,124,122,95,34.673298429319374,202011
구덕로점,1170,977,193,858,312,823,347,99,101,108,103,124,114,106,104,110,113,88,48.39918116683726,202011
구청로점,880,714,166,616,264,619,261,84,89,75,90,79,74,78,71,89,79,72,33.796918767507,202011
국제금융로2점,728,595,133,549,179,509,219,79,62,55,61,65,77,66,49,80,73,61,48.46050420168067,202011
국제금융로점,1360,1093,267,1020,340,954,406,121,121,119,110,132,119,131,125,118,125,139,35.05580969807868,202011
금송로점,1268,1031,237,913,355,887,381,120,147,112,116,107,106,110,96,118,113,123,33.96896217264791,202011
금화로점,1297,1047,250,975,322,907,390,115,118,123,138,102,112,119,108,101,148,113,34.55396370582617,202011
기장대로점,1450,1205,245,1079,371,1016,434,160,116,122,119,129,145,124,129,128,152,126,34.24896265560166,202011
기흥점,1061,869,192,786,275,741,320,110,94,92,85,109,83,94,94,118,91,91,34.03682393555811,202011
낙동대로2점,1438,1154,284,1068,370,1004,434,138,123,130,140,129,123,117,141,122,143,132,34.76429809358752,202011
낙동대로점,1199,986,213,877,322,839,360,95,108,119,121,102,128,97,111,102,96,120,33.58215010141988,202011
낙동북로점,1122,916,206,823,299,788,334,90,96,129,91,97,102,106,100,89,112,110,34.46615720524017,202011
남동남로점,1361,1120,241,988,373,952,409,125,128,126,132,118,132,131,109,122,120,118,34.22767857142857,202011
남부순환로2점,1505,1221,284,1136,369,1053,452,122,134,141,114,151,139,145,135,145,141,138,34.20966420966421,202011
남부순환로점,1205,975,230,884,321,840,365,104,96,133,106,98,109,99,117,116,115,112,34.834871794871795,202011
남천동로점,965,809,156,723,242,675,290,85,96,93,92,87,71,76,93,89,80,103,34.326328800988875,202011
내방로점,1320,1083,237,993,327,919,401,121,112,127,131,127,118,113,132,99,114,126,20.169898430286242,202011
노해로2점,1619,1305,314,1183,436,1135,484,156,154,149,130,142,137,153,161,164,144,129,34.52107279693487,202011
노해로점,1181,973,208,879,302,826,355,97,125,113,99,129,108,102,98,90,112,108,34.45015416238438,202011
녹사평대로2점,1533,1246,287,1158,375,1074,459,149,148,147,152,151,112,152,149,106,135,132,34.60674157303371,202011
녹사평대로점,1358,1082,276,1021,337,955,403,132,130,114,123,118,111,111,117,136,144,122,34.52218114602588,202011
다대동로점,1412,1148,264,1081,331,989,423,111,133,131,142,114,141,135,114,140,125,126,34.06010452961672,202011
달맞이길점,1326,1054,272,969,357,928,398,132,102,130,118,110,106,123,141,115,130,119,34.45445920303605,202011
당산로2점,1360,1120,240,1015,345,950,410,108,123,121,136,140,132,109,127,125,127,112,34.53392857142857,202011
당산로점,1059,885,174,796,263,746,313,94,113,100,92,110,88,82,86,83,102,109,48.907344632768364,202011
대둔산로점,1446,1188,258,1075,371,1015,431,133,129,119,135,129,143,136,138,135,135,114,34.23905723905724,202011
대전로점,1143,924,219,840,303,801,342,97,95,92,117,106,106,91,115,100,125,99,47.061688311688314,202011
대종로점,1462,1216,246,1076,386,1026,436,134,129,137,122,120,127,140,139,138,141,135,34.65953947368421,202011
대흥로점,823,670,153,595,228,577,246,64,66,81,80,65,73,87,75,79,83,70,34.0910447761194,202011
덕남길점,1299,1040,259,951,348,908,391,115,106,116,120,131,112,139,117,108,132,103,34.79519230769231,202011
덕수궁길2점,1170,972,198,879,291,817,353,110,106,103,120,111,106,110,86,113,106,99,35.42181069958848,202011
덕수궁길점,997,817,180,746,251,696,301,68,86,105,108,85,89,87,99,89,88,93,34.92411260709914,202011
도봉로2점,946,779,167,722,224,661,285,81,102,76,103,68,81,94,85,87,91,78,48.011553273427474,202011
도봉로점,1263,1040,223,955,308,885,378,120,98,111,127,122,113,118,114,108,128,104,34.89230769230769,202011
동구청로점,1300,1045,255,979,321,910,390,130,123,122,132,124,122,128,82,98,113,126,34.5177033492823,202011
둔산로점,1091,908,183,796,295,763,328,105,92,89,107,106,107,96,96,109,100,84,20.63546255506608,202011
둔산서로점,1144,952,192,862,282,799,345,95,102,109,114,98,107,113,79,105,115,107,34.79621848739496,202011
둔산중로점,1092,898,194,803,289,765,327,77,112,103,107,103,93,98,94,104,105,96,34.5913140311804,202011
르노삼성대로점,1061,857,204,803,258,742,319,114,97,96,106,99,104,90,97,86,87,85,34.212368728121355,202011
마들로2점,1036,821,215,785,251,727,309,111,79,88,96,89,80,95,102,88,108,100,35.25091352009744,202011
마들로점,1434,1168,266,1063,371,1002,432,136,126,128,127,142,131,126,127,130,126,135,34.52568493150685,202011
마린시티1로점,907,758,149,667,240,633,274,82,75,73,67,90,93,106,87,73,78,83,33.91952506596306,202011
마포대로2점,1324,1098,226,1010,314,926,398,117,128,116,128,122,113,103,134,118,121,124,35.091985428051004,202011
마포대로점,1382,1138,244,1024,358,968,414,123,116,139,138,116,136,133,110,142,113,116,34.13005272407733,202011
망양로점,1325,1062,263,970,355,927,398,127,135,118,118,116,118,123,131,126,103,110,34.14689265536723,202011
명지국제7로점,1149,925,224,834,315,804,345,121,90,102,121,102,91,86,124,102,104,106,34.902702702702705,202011
명지동점,1266,1053,213,948,318,892,374,113,119,118,119,111,104,128,115,129,102,108,34.338081671415004,202011
명지새동네길점,1129,919,210,826,303,798,331,112,88,100,87,123,91,117,104,97,108,102,34.42328618063112,202011
목공동로2점,1436,1168,268,1050,386,1007,429,140,120,116,145,143,132,116,117,124,149,134,34.62842465753425,202011
목공동로점,1135,920,215,827,308,794,341,103,99,105,83,113,107,109,113,93,112,98,46.74891304347826,202011
못골로점,1085,881,204,804,281,757,328,98,89,88,96,122,108,91,91,104,101,97,34.3427922814983,202011
무교로2점,1528,1273,255,1143,385,1071,457,138,128,144,122,133,147,125,141,144,147,159,34.825608798114686,202011
무교로점,847,680,167,644,203,591,256,89,79,71,78,85,87,67,79,78,68,66,34.417647058823526,202011
문예회관길점,1170,977,193,845,325,819,351,111,99,96,118,103,93,109,114,120,101,106,20.255885363357216,202011
민락수변로점,1261,1038,223,916,345,882,379,98,94,112,81,121,120,115,122,127,128,143,34.90077071290944,202011
방죽로점,1196,961,235,877,319,842,354,125,104,104,106,108,101,113,126,107,95,107,34.005202913631635,202011
배재로점,1467,1160,307,1064,403,1026,441,128,148,138,129,130,142,150,137,119,111,135,34.001724137931035,202011
법원로2점,1288,1069,219,964,324,902,386,137,106,141,109,112,113,118,108,111,121,112,34.81852198316184,202011
법원로점,2240,1817,423,1665,575,1568,672,230,227,183,209,210,195,194,184,211,185,212,34.42872867363786,202011
보문로2점,1055,855,200,792,263,739,316,106,90,78,88,105,105,95,93,97,95,103,34.134502923976605,202011
보문로점,1146,938,208,855,291,803,343,108,111,116,102,105,100,91,109,94,96,114,34.6183368869936,202011
복수서로점,882,746,136,654,228,619,263,82,72,78,93,71,86,69,88,78,86,79,34.05361930294906,202011
봉선로점,1138,935,203,843,295,801,337,101,98,104,119,96,88,92,104,116,103,117,35.01925133689839,202011
봉화산로2점,973,813,160,729,244,684,289,78,87,109,84,85,91,97,71,94,107,70,34.551045510455104,202011
봉화산로점,795,650,145,598,197,556,239,73,62,69,79,60,77,61,83,73,80,78,34.91384615384615,202011
부흥로점,1316,1095,221,963,353,924,392,112,121,141,127,121,113,128,118,117,98,120,34.945205479452056,202011
북유성대로점,1264,1039,225,928,336,886,378,113,118,101,114,109,118,139,133,91,108,120,34.64677574590953,202011
분포로점,1497,1222,275,1121,376,1049,448,141,153,134,140,144,132,118,162,126,117,130,34.329787234042556,202011
비아로점,1496,1218,278,1125,371,1050,446,137,133,140,133,144,129,140,128,128,134,150,34.592775041050906,202011
사우중로점,1585,1319,266,1172,413,1108,477,132,140,159,140,137,145,151,142,146,152,141,34.315390447308566,202011
사직로2점,999,813,186,717,282,698,301,87,92,90,96,98,85,90,93,86,88,94,34.35793357933579,202011
사직로점,2247,1835,412,1667,580,1574,673,191,207,185,215,238,201,215,181,202,200,212,34.804904632152585,202011
삼봉로2점,1324,1077,247,1008,316,925,399,109,113,116,111,138,128,127,133,114,129,106,34.44289693593315,202011
삼봉로점,990,777,213,747,243,694,296,84,88,92,88,90,102,96,104,70,93,83,34.48133848133848,202011
삼일대로2점,969,791,178,743,226,676,293,89,81,73,90,91,87,91,93,93,87,94,34.43615676359039,202011
삼일대로점,1173,955,218,857,316,820,353,119,100,110,115,93,111,104,106,99,129,87,35.49005235602094,202011
상무공원로점,1385,1149,236,1006,379,973,412,117,126,128,130,120,121,130,127,142,122,122,34.335944299390775,202011
상무대로점,1083,861,222,829,254,759,324,111,80,85,96,106,102,89,93,105,116,100,35.39488966318235,202011
상무번영로점,874,718,156,638,236,615,259,64,81,90,92,84,83,81,59,66,81,93,48.78551532033426,202011
서남로점,1090,889,201,795,295,763,327,80,105,113,116,98,108,79,102,93,96,100,35.40944881889764,202011
서소문로2점,1005,808,197,723,282,701,304,78,78,86,108,97,98,107,74,92,97,90,34.05569306930693,202011
서소문로점,1236,1027,209,922,314,862,374,114,103,124,120,120,115,107,111,109,118,95,34.721518987341774,202011
서초중앙로2점,1207,1009,198,915,292,844,363,108,123,101,103,105,116,122,87,120,124,98,33.89791873141724,202011
서초중앙로3점,1051,867,184,784,267,735,316,97,76,86,105,102,104,88,91,108,95,99,34.34832756632065,202011
서초중앙로점,1116,900,216,824,292,781,335,100,105,117,99,98,94,101,110,100,95,97,34.654444444444444,202011
서하로점,1506,1231,275,1114,392,1054,452,143,140,145,133,133,114,131,128,140,156,143,34.34281072298944,202011
석봉로점,814,676,138,620,194,570,244,78,75,65,75,46,88,79,68,72,86,82,33.8387573964497,202011
성남대로점,1488,1217,271,1117,371,1040,448,127,133,133,149,148,126,131,131,128,146,136,33.77156943303205,202011
성내로2점,1270,1051,219,948,322,889,381,105,100,107,110,117,113,114,122,129,135,118,34.58896289248335,202011
성내로점,949,767,182,697,252,662,287,80,95,86,88,88,72,87,103,83,84,83,47.73924380704042,202011
성산동2점,1315,1087,228,985,330,920,395,118,117,125,106,120,118,137,110,122,125,117,33.90892364305428,202011
성산동점,999,806,193,743,256,700,299,86,96,96,80,94,100,76,103,81,104,83,20.555831265508687,202011
세종대로2점,1035,851,184,776,259,723,312,107,92,97,99,102,96,109,84,71,91,87,35.18801410105758,202011
세종대로점,1137,942,195,863,274,796,341,84,106,103,92,109,92,98,119,110,117,107,34.518046709129514,202011
세종로점,1143,942,201,855,288,803,340,91,108,102,122,110,108,84,103,99,110,106,34.02866242038217,202011
송정공원로점,886,720,166,662,224,621,265,73,85,86,72,93,84,96,78,74,87,58,34.84722222222222,202011
송정해변로점,1529,1246,283,1142,387,1071,458,170,132,144,135,128,152,139,108,127,142,152,20.130818619582666,202011
시흥대로2점,967,776,191,709,258,678,289,78,84,73,108,98,94,93,82,88,92,77,34.17654639175258,202011
시흥대로점,1204,984,220,895,309,846,358,115,117,123,123,91,104,123,86,116,109,97,34.38109756097561,202011
신갈마로점,1149,933,216,874,275,803,346,119,110,115,110,115,84,97,100,109,100,90,35.166130760986064,202011
신일동로점,1325,1090,235,981,344,929,396,125,106,114,118,135,121,109,134,128,100,135,34.03119266055046,202011
신일서로점,1235,1005,230,910,325,861,374,99,104,113,114,104,111,105,103,130,119,133,34.48656716417911,202011
안양천로2점,1118,907,211,806,312,783,335,98,114,89,94,92,100,108,97,106,116,104,34.936052921719956,202011
안양천로점,1176,957,219,860,316,825,351,118,102,109,111,99,107,98,95,116,105,116,34.76175548589342,202011
양재2점,1269,1049,220,928,341,888,381,130,108,113,119,109,109,111,108,127,107,128,34.04385128693994,202011
양재점,1173,953,220,848,325,824,349,117,104,96,100,96,107,101,121,104,108,119,34.09548793284365,202011
어등대로점,1177,948,229,874,303,823,354,117,110,106,121,117,98,93,100,117,105,93,33.61708860759494,202011
엑스포로점,1079,867,212,786,293,754,325,104,118,101,105,109,96,109,74,91,85,87,35.042675893886965,202011
연제로점,1372,1115,257,990,382,961,411,129,129,142,133,122,133,116,135,113,108,112,34.11659192825112,202011
연희로2점,1379,1137,242,1020,359,963,416,126,127,132,116,113,128,132,120,142,124,119,34.33685136323659,202011
연희로점,1059,854,205,779,280,740,319,86,83,110,88,97,107,85,85,111,104,103,34.59016393442623,202011
영통구점,1059,863,196,794,265,742,317,82,106,97,113,106,86,104,94,94,86,91,34.63499420625724,202011
예술길점,1155,935,220,862,293,809,346,102,103,116,95,88,106,113,94,107,122,109,34.05026737967914,202011
온천천로점,1526,1232,294,1124,402,1068,458,136,139,130,131,117,160,137,144,139,145,148,33.92451298701299,202011
올림픽로2점,1354,1098,256,990,364,949,405,116,120,133,124,124,120,113,129,119,129,127,20.47632058287796,202011
올림픽로점,972,798,174,716,256,680,292,96,86,101,67,90,88,94,78,85,88,99,33.62907268170426,202011
용대로점,1028,836,192,732,296,719,309,78,80,107,97,96,106,88,91,107,88,90,34.2188995215311,202011
용아로점,1324,1092,232,957,367,927,397,111,117,148,121,112,124,102,118,114,139,118,35.464285714285715,202011
용운동점,853,687,166,637,216,599,254,83,87,76,71,82,74,82,75,80,72,71,34.47161572052402,202011
우치로점,1117,897,220,820,297,777,340,97,118,112,106,95,93,106,104,108,83,95,48.752508361204015,202011
월계로2점,1008,827,181,781,227,706,302,84,102,84,91,94,87,92,107,92,95,80,34.518742442563486,202011
월계로점,1208,1012,196,914,294,847,361,107,107,125,126,106,103,108,108,106,103,109,20.595849802371543,202011
월드컵대로2점,880,725,155,669,211,613,267,83,74,91,85,86,76,104,61,74,70,76,34.16275862068966,202011
월드컵대로점,1122,934,188,834,288,785,337,101,101,98,105,112,108,101,109,96,96,95,34.38115631691649,202011
월드컵로2점,1379,1115,264,1015,364,963,416,132,112,117,127,121,131,125,128,133,107,146,34.71300448430493,202011
월드컵로점,912,743,169,662,250,641,271,82,81,83,87,82,89,77,88,87,73,83,33.940780619111706,202011
은평로2점,858,710,148,628,230,599,259,79,83,63,79,79,83,68,80,82,69,93,35.384507042253524,202011
은평로점,1197,985,212,877,320,839,358,111,115,100,103,85,98,119,107,122,123,114,33.56243654822335,202011
일산동구점,1115,891,224,806,309,778,337,105,105,103,100,96,97,107,88,108,106,100,34.81818181818182,202011
자양로2점,1060,853,207,803,257,741,319,91,82,103,92,82,99,100,98,119,98,96,34.08089097303634,202011
자양로점,1145,940,205,868,277,798,347,108,96,104,98,103,119,101,120,90,104,102,35.36914893617021,202011
장대로점,1202,961,241,883,319,839,363,108,117,115,97,100,88,104,104,126,130,113,34.54734651404787,202011
장동로점,971,773,198,705,266,678,293,87,85,87,81,94,84,92,101,88,76,96,34.99223803363519,202011
장승배기로2점,1148,951,197,851,297,804,344,91,118,89,95,89,99,129,116,118,107,97,34.24815983175605,202011
장승배기로점,1118,903,215,820,298,781,337,91,94,88,96,120,111,98,97,101,106,116,19.85049833887043,202011
재반로점,1213,1008,205,905,308,848,365,98,126,101,97,112,116,138,101,101,115,108,34.08134920634921,202011
절영로점,1438,1177,261,1053,385,1008,430,132,142,135,121,125,142,105,143,121,133,139,33.82837723024639,202011
절재로점,1355,1117,238,1007,348,950,405,133,114,124,98,117,114,122,117,140,136,140,34.676812891674125,202011
제중로점,1143,914,229,821,322,799,344,115,99,105,106,103,94,87,121,110,118,85,34.304157549234134,202011
조치원점,1146,944,202,858,288,804,342,97,111,117,101,102,95,128,87,103,115,90,34.35699152542373,202011
종로2점,1500,1201,299,1120,380,1050,450,143,155,128,138,139,114,133,139,127,135,149,34.47876769358868,202011
종로점,1061,866,195,815,246,742,319,104,110,103,78,99,106,90,88,98,107,78,34.84526558891455,202011
준법로점,1106,907,199,830,276,771,335,83,99,116,95,99,103,97,90,109,111,104,35.104740904079385,202011
중구로점,1439,1184,255,1069,370,1012,427,130,141,114,134,127,126,123,154,125,122,143,34.28800675675676,202011
중동2로점,696,570,126,528,168,488,208,62,62,59,56,67,68,52,71,65,69,65,35.41228070175438,202011
중앙대로2점,1355,1101,254,1027,328,951,404,138,108,135,109,120,130,128,119,131,119,118,34.549500454132605,202011
중앙대로점,2179,1801,378,1601,578,1525,654,191,194,190,202,200,204,191,188,203,207,209,34.48139922265408,202011
증심사길점,1254,995,259,910,344,879,375,116,111,126,119,123,117,98,99,109,108,128,34.369849246231155,202011
창경궁로2점,1413,1171,242,1040,373,994,419,130,114,114,144,136,125,129,132,126,133,130,34.78736122971819,202011
창경궁로점,1245,1033,212,935,310,869,376,110,104,121,127,115,96,110,101,115,110,136,34.332042594385285,202011
처인구점,1000,835,165,756,244,700,300,69,102,90,83,93,101,98,88,104,100,72,35.463473053892216,202011
천호대로2점,1527,1242,285,1117,410,1070,457,142,133,135,151,131,145,123,137,153,131,146,34.69243156199678,202011
천호대로점,973,779,194,726,247,681,292,79,76,109,100,85,94,85,101,84,85,75,33.86777920410783,202011
첨단과기로점,1302,1056,246,964,338,912,390,118,108,97,133,108,124,116,135,119,117,127,33.91761363636363,202011
청계청로2점,1324,1079,245,999,325,929,395,114,134,110,119,130,123,120,106,124,129,115,34.05097312326228,202011
청계청로점,887,725,162,644,243,623,264,74,99,82,70,70,82,69,87,91,83,80,35.20413793103448,202011
청사포로점,1233,980,253,915,318,860,373,122,101,110,116,117,107,139,88,109,117,107,19.905102040816328,202011
태종로점,1149,955,194,856,293,804,345,102,101,120,95,110,102,105,107,91,116,100,34.37382198952879,202011
필문대로점,1143,948,195,850,293,801,342,103,110,97,99,107,102,106,88,127,113,91,34.35443037974684,202011
하남산단점,996,806,190,744,252,698,298,79,97,83,97,96,86,79,91,99,93,96,34.95781637717121,202011
하리해안길점,1125,909,216,822,303,790,335,88,104,108,113,90,108,91,101,105,99,118,34.41034103410341,202011
하신번영로점,1476,1214,262,1117,359,1033,443,141,129,124,153,133,130,141,141,143,118,123,34.09060955518946,202011
하신중앙로점,1211,982,229,930,281,848,363,113,115,117,132,120,99,118,108,105,90,94,33.484725050916495,202011
학감대로점,1387,1130,257,1060,327,971,416,133,130,117,129,127,128,132,117,122,131,121,34.29823008849557,202011
학동로2점,1411,1122,289,1029,382,992,419,107,121,127,135,135,123,136,124,136,130,137,34.60873440285205,202011
학동로점,1382,1139,243,999,383,968,414,107,131,111,140,118,131,135,136,119,132,122,34.397717295873576,202011
한남로점,994,831,163,744,250,697,297,87,84,96,100,102,80,75,102,80,94,94,33.820697954271964,202011
한누리대로점,1261,1045,216,932,329,881,380,113,120,126,111,122,108,101,127,115,108,110,34.33971291866029,202011
한밭대로점,1059,850,209,818,241,745,314,99,108,74,85,108,114,98,90,93,98,92,47.8164705882353,202011
해안새벽시장길점,1211,989,222,893,318,850,361,105,120,114,128,111,98,98,105,112,112,108,34.42770475227503,202011
해운대로점,1388,1151,237,1017,371,974,414,122,110,134,122,107,140,129,122,132,145,125,34.45873153779322,202011
해운대해변로점,1005,828,177,702,303,705,300,94,108,111,89,81,94,74,84,97,90,83,20.070048309178745,202011
화곡로2점,1179,967,212,872,307,824,355,89,90,120,121,102,93,102,108,108,145,101,35.34022750775595,202011
화곡로점,1064,886,178,785,279,747,317,94,95,107,102,112,93,98,87,98,100,78,35.42099322799097,202011
화중로점,1145,924,221,829,316,802,343,90,126,121,94,103,100,99,120,102,87,103,34.925324675324674,202011
효덕로점,1294,1067,227,937,357,906,388,117,114,113,121,105,126,109,129,102,127,131,35.111527647610124,202011
효원로점,784,638,146,602,182,548,236,55,65,76,69,70,77,68,74,89,79,62,34.460815047021946,202011
가덕해안로점,1036,839,197,779,257,770,266,95,95,110,95,70,89,90,95,97,100,100,34.39213349225268,202012
가마산로2점,1511,1238,273,1127,384,1117,394,136,155,130,143,125,133,152,132,135,125,145,34.817447495961225,202012
가마산로점,1064,864,200,767,297,790,274,110,86,103,109,82,73,96,93,105,102,105,34.34722222222222,202012
감천항로점,1031,836,195,785,246,765,266,90,98,92,97,87,101,87,121,75,98,85,35.04306220095694,202012
강남대로2점,1122,906,216,826,296,833,289,102,95,115,126,96,91,90,111,99,89,108,34.70860927152318,202012
강남대로점,1087,865,222,799,288,807,280,112,101,104,98,96,98,81,87,103,92,115,34.264739884393066,202012
강남점3점,1316,1082,234,997,319,974,342,130,112,144,123,99,100,117,139,103,119,130,34.4547134935305,202012
경열로점,1174,964,210,905,269,874,300,107,120,114,98,89,118,103,104,128,88,105,34.56742738589212,202012
계룡로점,1436,1170,266,1050,386,1065,371,141,137,135,125,134,116,116,142,138,122,130,34.802564102564105,202012
계족로점,1190,967,223,851,339,885,305,136,111,106,89,96,108,104,104,115,123,98,34.61737331954498,202012
고산자로2점,1427,1184,243,1077,350,1057,370,136,138,136,148,123,117,133,116,120,138,122,34.835304054054056,202012
고산자로점,1063,879,184,797,266,788,275,87,84,105,99,88,112,95,99,80,98,116,34.40386803185438,202012
관악로2점,1461,1182,279,1094,367,1085,376,136,126,131,133,138,139,135,126,131,142,124,34.22758037225042,202012
관악로점,1154,930,224,844,310,853,301,110,107,121,94,97,106,96,91,85,126,121,34.88172043010753,202012
관저동로점,1497,1228,269,1100,397,1112,385,131,146,136,134,132,149,146,145,113,139,126,34.78990228013029,202012
광산로점,1004,806,198,734,270,748,256,81,88,91,89,115,85,85,120,75,93,82,34.54838709677419,202012
광주여대길점,1245,1052,193,916,329,926,319,114,119,110,106,118,114,120,128,90,104,122,34.458174904942965,202012
구덕로점,1212,991,221,884,328,901,311,97,113,95,112,96,128,112,108,121,103,127,46.63874873864783,202012
구청로점,911,764,147,699,212,676,235,85,85,91,87,98,100,57,82,75,75,76,34.63350785340314,202012
국제금융로2점,755,593,162,561,194,563,192,75,66,56,65,70,73,77,72,76,60,65,48.136593591905566,202012
국제금융로점,1397,1159,238,1010,387,1035,362,133,128,137,126,145,136,115,118,142,125,92,34.3572044866264,202012
금송로점,1312,1072,240,941,371,971,341,118,121,128,122,113,128,101,108,128,109,136,34.85914179104478,202012
금화로점,1342,1091,251,1018,324,996,346,119,136,123,109,142,108,116,115,137,122,115,34.575618698441794,202012
기장대로점,1490,1200,290,1103,387,1102,388,143,132,148,140,128,107,124,146,148,134,140,34.15083333333333,202012
기흥점,1098,888,210,844,254,816,282,92,102,100,88,107,89,92,108,99,114,107,34.64301801801802,202012
낙동대로2점,1482,1205,277,1115,367,1100,382,132,129,133,129,134,138,141,128,136,149,133,34.40829875518672,202012
낙동대로점,1251,1015,236,923,328,931,320,126,91,118,125,135,111,115,107,115,108,100,34.6256157635468,202012
낙동북로점,1159,934,225,835,324,858,301,101,121,107,94,94,111,100,112,103,100,116,35.144539614561026,202012
남동남로점,1394,1140,254,1022,372,1036,358,152,126,106,128,121,118,114,142,121,129,137,34.83771929824562,202012
남부순환로2점,1554,1294,260,1158,396,1155,399,148,127,132,138,146,146,156,125,158,153,125,34.5,202012
남부순환로점,1254,1018,236,919,335,930,324,120,118,111,119,109,102,135,108,113,101,118,34.49803536345776,202012
남천동로점,1002,836,166,729,273,743,259,96,85,100,72,101,94,98,84,87,94,91,34.41746411483253,202012
내방로점,1363,1130,233,1017,346,1011,352,121,136,113,116,135,122,122,127,119,127,125,20.631858407079648,202012
노해로2점,1668,1350,318,1235,433,1238,430,158,141,153,142,169,154,167,159,131,149,145,34.925185185185185,202012
노해로점,1218,1004,214,880,338,910,308,115,105,108,108,132,118,110,97,111,108,106,34.02191235059761,202012
녹사평대로2점,1566,1270,296,1150,416,1160,406,151,140,151,144,126,169,139,133,128,146,139,34.53700787401575,202012
녹사평대로점,1395,1133,262,1006,389,1037,358,115,127,130,153,130,113,125,121,120,136,125,34.27449249779347,202012
다대동로점,1460,1190,270,1051,409,1083,377,123,143,145,155,152,137,124,111,120,140,110,34.55042016806723,202012
달맞이길점,1362,1103,259,1009,353,1011,351,132,138,125,117,111,117,126,135,120,127,114,34.0362647325476,202012
당산로2점,1398,1153,245,1021,377,1038,360,131,142,125,121,116,126,158,121,109,133,116,34.633998265394624,202012
당산로점,1090,870,220,812,278,806,284,101,101,82,97,106,96,103,114,87,114,89,48.326436781609196,202012
대둔산로점,1483,1238,245,1113,370,1098,385,123,140,134,164,127,131,142,134,134,123,131,33.978190630048466,202012
대전로점,1181,966,215,877,304,876,305,114,101,111,104,126,100,113,108,98,111,95,48.33540372670807,202012
대종로점,1531,1257,274,1108,423,1138,393,115,153,137,124,153,140,133,131,145,141,159,34.1909307875895,202012
대흥로점,852,699,153,628,224,630,222,99,97,78,66,80,70,61,83,70,74,74,34.72818311874106,202012
덕남길점,1345,1095,250,998,347,998,347,126,127,121,134,121,110,123,127,123,115,118,34.43561643835616,202012
덕수궁길2점,1220,995,225,913,307,908,312,134,114,117,123,119,96,102,107,95,116,97,33.95276381909548,202012
덕수궁길점,1034,837,197,746,288,766,268,79,83,101,92,115,83,94,95,98,90,104,35.2652329749104,202012
도봉로2점,974,795,179,725,249,728,246,78,99,76,94,91,89,98,97,96,96,60,48.867924528301884,202012
도봉로점,1299,1080,219,939,360,967,332,158,115,118,106,130,111,113,108,120,114,106,33.92962962962963,202012
동구청로점,1332,1056,276,971,361,987,345,122,138,124,113,117,113,115,128,105,129,128,34.541666666666664,202012
둔산로점,1127,921,206,837,290,837,290,106,93,93,113,94,105,104,99,114,94,112,20.321389793702497,202012
둔산서로점,1180,957,223,852,328,873,307,122,88,111,127,118,105,101,104,100,99,105,34.90909090909091,202012
둔산중로점,1122,909,213,825,297,832,290,103,126,104,92,103,96,109,108,101,84,96,34.5984598459846,202012
르노삼성대로점,1089,904,185,798,291,809,280,96,90,110,84,104,99,117,100,93,99,97,34.25,202012
마들로2점,1064,867,197,787,277,788,276,101,96,95,100,103,83,108,94,95,98,91,34.7439446366782,202012
마들로점,1493,1226,267,1119,374,1104,389,130,131,125,170,142,134,127,139,140,119,136,35.331973898858074,202012
마린시티1로점,949,791,158,708,241,703,246,82,90,77,74,81,87,88,105,89,82,94,35.35018963337547,202012
마포대로2점,1369,1126,243,1037,332,1017,352,129,108,120,133,122,126,132,126,131,117,125,34.34547069271758,202012
마포대로점,1425,1141,284,1057,368,1060,365,126,127,119,127,117,136,115,147,148,135,128,34.34005258545136,202012
망양로점,1367,1123,244,1003,364,1012,355,128,124,113,115,117,120,129,119,135,128,139,33.74888691006233,202012
명지국제7로점,1183,995,188,876,307,882,301,115,104,112,97,96,107,114,116,103,120,99,34.9537688442211,202012
명지동점,1311,1082,229,965,346,973,338,123,113,122,115,119,131,116,117,121,127,107,33.87153419593346,202012
명지새동네길점,1190,988,202,854,336,887,303,119,113,124,120,117,112,111,100,97,84,93,34.522267206477736,202012
목공동로2점,1494,1222,272,1107,387,1106,388,132,138,142,142,117,124,160,160,111,151,117,33.98199672667758,202012
목공동로점,1185,973,212,874,311,875,310,124,96,124,109,98,103,119,90,104,105,113,47.775950668037,202012
못골로점,1125,903,222,836,289,834,291,102,101,101,91,103,98,110,102,97,104,116,34.06866002214839,202012
무교로2점,1579,1296,283,1162,417,1173,406,142,125,143,133,145,134,147,132,166,156,156,34.310956790123456,202012
무교로점,879,708,171,660,219,650,229,64,82,89,80,61,88,83,90,76,96,70,34.186440677966104,202012
문예회관길점,1224,991,233,903,321,909,315,109,113,96,95,105,123,106,114,126,119,118,20.367305751765894,202012
민락수변로점,1309,1061,248,993,316,969,340,119,116,133,120,121,120,120,103,132,106,119,34.60603204524034,202012
방죽로점,1250,1001,249,938,312,924,326,100,125,115,118,114,110,107,111,118,109,123,34.09390609390609,202012
배재로점,1518,1243,275,1136,382,1124,394,141,127,148,121,123,150,151,152,131,135,139,34.395816572807725,202012
법원로2점,1344,1102,242,977,367,996,348,148,119,114,111,120,133,131,129,122,105,112,34.96188747731397,202012
법원로점,2307,1865,442,1725,582,1712,595,218,204,215,199,206,202,187,234,204,209,229,34.27292225201072,202012
보문로2점,1096,873,223,824,272,812,284,111,86,87,97,90,94,91,96,126,124,94,34.26231386025201,202012
보문로점,1187,970,217,867,320,880,307,121,106,100,97,102,118,100,117,133,95,98,33.78041237113402,202012
복수서로점,909,752,157,689,220,674,235,91,99,77,86,75,86,77,75,78,76,89,34.255319148936174,202012
봉선로점,1178,967,211,904,274,880,298,106,105,116,107,104,114,110,109,79,110,118,34.20889348500517,202012
봉화산로2점,1002,816,186,745,257,745,257,92,99,87,92,93,87,90,84,91,85,102,34.08946078431372,202012
봉화산로점,822,659,163,622,200,610,212,76,61,78,73,80,68,84,71,71,80,80,33.977238239757206,202012
부흥로점,1353,1099,254,1002,351,1005,348,116,128,125,119,129,121,113,136,132,116,118,34.86988171064604,202012
북유성대로점,1307,1043,264,963,344,968,339,121,120,113,121,136,116,119,143,102,121,95,34.2464046021093,202012
분포로점,1553,1280,273,1154,399,1148,405,137,127,147,159,135,162,115,134,136,145,156,34.35,202012
비아로점,1548,1273,275,1155,393,1150,398,132,146,142,136,135,123,150,162,137,149,136,34.20031421838178,202012
사우중로점,1639,1325,314,1213,426,1221,418,163,160,159,144,125,154,153,128,149,146,158,34.56528301886792,202012
사직로2점,1033,846,187,763,270,764,269,93,113,87,92,90,98,89,106,91,80,94,34.52482269503546,202012
사직로점,2338,1916,422,1759,579,1735,603,203,231,199,201,184,225,212,214,228,216,225,34.17275574112735,202012
삼봉로2점,1365,1122,243,1028,337,1011,354,124,117,95,149,128,125,138,126,128,126,109,35.05347593582888,202012
삼봉로점,1035,861,174,782,253,766,269,85,104,94,99,97,91,104,109,79,88,85,34.71312427409988,202012
삼일대로2점,997,832,165,734,263,736,261,82,83,97,86,107,92,81,84,88,102,95,34.06610576923077,202012
삼일대로점,1205,971,234,880,325,892,313,107,113,118,115,98,101,102,113,131,104,103,33.71884654994851,202012
상무공원로점,1426,1159,267,1070,356,1060,366,135,114,110,121,133,125,123,153,150,131,131,34.44521138912856,202012
상무대로점,1128,914,214,818,310,838,290,103,93,96,97,110,90,104,113,107,114,101,34.774617067833695,202012
상무번영로점,912,742,170,691,221,674,238,72,80,77,93,86,75,82,85,74,105,83,47.96495956873316,202012
서남로점,1123,937,186,832,291,831,292,104,105,99,96,97,105,93,97,122,111,94,34.5923159018143,202012
서소문로2점,1036,870,166,786,250,769,267,92,103,94,80,87,107,78,99,91,99,106,34.69310344827586,202012
서소문로점,1279,1021,258,977,302,947,332,113,109,123,104,124,113,143,126,105,111,108,35.22526934378061,202012
서초중앙로2점,1244,1020,224,924,320,922,322,121,112,106,123,102,113,121,117,103,104,122,34.65294117647059,202012
서초중앙로3점,1095,905,190,816,279,815,280,115,124,89,107,88,85,96,98,103,87,103,34.3756906077348,202012
서초중앙로점,1155,921,234,860,295,858,297,88,104,110,109,113,102,109,99,125,96,100,35.11726384364821,202012
서하로점,1545,1264,281,1136,409,1144,401,149,144,149,118,137,130,136,139,155,145,143,34.022943037974684,202012
석봉로점,849,716,133,637,212,630,219,59,88,81,67,78,77,79,81,76,78,85,34.75977653631285,202012
성남대로점,1536,1267,269,1122,414,1137,399,137,125,134,142,125,163,145,138,143,146,138,33.74743488555643,202012
성내로2점,1309,1065,244,948,361,970,339,109,106,134,118,137,128,123,118,115,101,120,34.52300469483568,202012
성내로점,974,807,167,703,271,722,252,87,86,82,77,86,107,96,80,91,87,95,48.921933085501855,202012
성산동2점,1359,1084,275,985,374,1009,350,116,114,100,130,135,136,142,139,120,111,116,34.252767527675275,202012
성산동점,1038,828,210,791,247,772,266,105,101,87,84,109,96,93,89,85,92,97,20.095410628019323,202012
세종대로2점,1067,892,175,790,277,790,277,91,105,105,98,95,108,77,106,77,102,103,33.82511210762332,202012
세종대로점,1187,974,213,871,316,880,307,119,118,100,113,99,105,93,100,113,111,116,34.8264887063655,202012
세종로점,1187,959,228,891,296,882,305,103,112,91,125,107,104,109,108,106,119,103,34.90823774765381,202012
송정공원로점,918,735,183,690,228,679,239,93,80,71,85,82,85,82,75,80,82,103,35.01768707482993,202012
송정해변로점,1574,1278,296,1144,430,1169,405,134,157,136,158,166,134,150,143,127,141,128,19.794209702660407,202012
시흥대로2점,1005,812,193,741,264,748,257,94,92,109,77,83,84,95,98,104,84,85,35.65024630541872,202012
시흥대로점,1253,1010,243,903,350,927,326,126,124,124,111,118,108,109,109,102,110,112,34.32475247524752,202012
신갈마로점,1176,970,206,880,296,874,302,112,120,101,103,89,105,102,106,104,104,130,34.597938144329895,202012
신일동로점,1368,1124,244,993,375,1013,355,125,116,126,139,127,140,127,109,114,124,121,34.245551601423486,202012
신일서로점,1276,1051,225,953,323,943,333,108,112,120,126,116,111,127,128,107,106,115,34.4814462416746,202012
안양천로2점,1154,937,217,851,303,857,297,89,106,109,103,113,98,126,102,101,115,92,34.5795090715048,202012
안양천로점,1215,1008,207,914,301,901,314,109,100,98,120,106,118,98,116,115,106,129,34.11309523809524,202012
양재2점,1306,1081,225,978,328,968,338,133,94,113,134,116,112,116,117,125,124,122,34.02867715078631,202012
양재점,1217,978,239,871,346,903,314,102,119,113,126,100,88,107,117,121,107,117,34.286298568507156,202012
어등대로점,1214,983,231,918,296,903,311,116,111,99,114,109,109,127,112,91,118,108,34.03051881993896,202012
엑스포로점,1130,923,207,841,289,838,292,96,103,120,83,90,111,120,96,98,106,107,34.5557963163597,202012
연제로점,1435,1169,266,1064,371,1065,370,123,128,138,123,141,118,122,118,130,146,148,34.39606501283148,202012
연희로2점,1422,1155,267,1057,365,1053,369,124,125,124,136,140,128,140,147,119,117,122,34.43809523809524,202012
연희로점,1096,879,217,826,270,813,283,128,107,94,98,98,93,77,108,101,97,95,33.75085324232082,202012
영통구점,1096,895,201,850,246,812,284,107,104,92,98,112,106,104,84,97,95,97,35.09162011173184,202012
예술길점,1189,975,214,874,315,883,306,100,88,114,120,121,101,106,100,113,111,115,34.397948717948715,202012
온천천로점,1579,1273,306,1194,385,1175,404,174,139,120,148,140,145,159,156,146,137,115,34.61901021209741,202012
올림픽로2점,1400,1139,261,1056,344,1037,363,120,136,129,144,141,131,120,127,131,115,106,19.98156277436348,202012
올림픽로점,1003,808,195,753,250,749,254,98,93,81,100,99,85,76,81,99,95,96,33.76732673267327,202012
용대로점,1068,879,189,788,280,790,278,94,104,104,74,101,111,100,85,99,101,95,34.18657565415245,202012
용아로점,1366,1123,243,1004,362,1015,351,123,125,126,127,125,136,126,117,124,122,115,34.26268922528941,202012
용운동점,885,723,162,648,237,656,229,74,85,75,85,74,93,71,90,87,73,78,34.130013831258644,202012
우치로점,1157,941,216,831,326,858,299,109,102,94,91,114,118,120,96,103,102,108,47.64187035069075,202012
월계로2점,1034,861,173,760,274,773,261,102,81,104,103,93,91,78,82,104,110,86,34.199767711962835,202012
월계로점,1253,1014,239,937,316,932,321,105,110,122,101,121,128,101,129,113,118,105,19.909270216962526,202012
월드컵대로2점,908,737,171,677,231,674,234,90,74,81,91,80,87,80,68,83,89,85,35.11261872455902,202012
월드컵대로점,1148,922,226,862,286,850,298,119,93,99,114,101,106,102,98,112,97,107,34.78741865509761,202012
월드컵로2점,1420,1174,246,1042,378,1054,366,135,104,130,126,136,141,118,117,135,155,123,34.94974446337309,202012
월드컵로점,945,756,189,706,239,701,244,97,88,85,77,74,90,86,90,82,93,83,34.29365079365079,202012
은평로2점,881,703,178,646,235,653,228,77,75,80,68,86,68,94,79,76,84,94,34.200568990042676,202012
은평로점,1249,1003,246,923,326,925,324,107,118,138,117,108,124,116,105,113,110,93,34.81754735792622,202012
일산동구점,1160,940,220,851,309,860,300,115,105,115,102,116,100,101,88,94,107,117,33.827659574468086,202012
자양로2점,1092,900,192,809,283,807,285,97,110,106,91,105,96,88,95,107,103,94,34.03,202012
자양로점,1184,966,218,857,327,880,304,102,106,103,104,120,102,96,106,118,129,98,34.462732919254655,202012
장대로점,1249,1013,236,940,309,927,322,119,114,116,115,122,99,106,120,102,120,116,34.778874629812435,202012
장동로점,997,809,188,756,241,740,257,114,83,87,91,97,114,78,74,88,86,85,34.6168108776267,202012
장승배기로2점,1195,983,212,876,319,888,307,102,112,117,99,112,107,114,106,102,107,117,34.924720244150556,202012
장승배기로점,1155,925,230,882,273,858,297,104,111,120,97,105,94,124,90,104,105,101,20.481081081081083,202012
재반로점,1246,1001,245,921,325,926,320,111,107,115,114,90,121,113,123,99,141,112,34.28071928071928,202012
절영로점,1482,1214,268,1115,367,1100,382,154,115,130,125,136,124,138,140,151,151,118,34.12767710049423,202012
절재로점,1391,1144,247,1022,369,1032,359,123,134,148,117,146,109,119,136,106,130,123,34.10052447552447,202012
제중로점,1185,950,235,859,326,877,308,122,111,96,101,126,91,109,114,104,100,111,34.92631578947368,202012
조치원점,1184,963,221,855,329,878,306,99,111,86,116,107,92,118,112,112,113,118,34.05607476635514,202012
종로2점,1544,1241,303,1165,379,1148,396,152,138,138,120,150,138,138,157,119,151,143,33.910556003223206,202012
종로점,1093,886,207,775,318,812,281,103,102,93,107,100,97,94,110,91,90,106,34.652370203160274,202012
준법로점,1152,922,230,848,304,852,300,97,115,114,96,108,124,115,89,97,110,87,34.47830802603037,202012
중구로점,1486,1212,274,1085,401,1101,385,126,134,130,139,131,140,119,137,129,169,132,34.82095709570957,202012
중동2로점,730,611,119,549,181,541,189,59,86,61,75,59,62,79,68,61,55,65,34.803600654664486,202012
중앙대로2점,1396,1138,258,1020,376,1031,365,124,110,134,128,122,129,131,110,134,139,135,34.09138840070299,202012
중앙대로점,2262,1859,403,1669,593,1679,583,217,190,174,178,232,195,232,212,191,196,245,34.20010758472297,202012
증심사길점,1312,1076,236,996,316,973,339,128,139,128,93,117,132,114,113,116,109,123,35.04368029739777,202012
창경궁로2점,1456,1214,242,1082,374,1080,376,151,140,111,124,125,141,129,149,116,138,132,34.23064250411861,202012
창경궁로점,1283,1052,231,978,305,951,332,125,109,110,126,121,98,108,126,121,115,124,35.05608365019011,202012
처인구점,1044,864,180,758,286,776,268,112,108,91,91,100,74,109,84,85,101,89,35.267361111111114,202012
천호대로2점,1578,1284,294,1129,449,1167,411,132,124,155,143,148,143,141,171,142,140,139,35.22507788161994,202012
천호대로점,1000,807,193,729,271,743,257,82,97,93,91,110,90,82,107,80,86,82,34.46716232961586,202012
첨단과기로점,1337,1108,229,1000,337,992,345,114,131,118,106,128,116,122,127,125,130,120,34.251805054151625,202012
청계청로2점,1370,1140,230,1019,351,1014,356,130,116,106,124,122,128,116,146,119,139,124,34.09736842105263,202012
청계청로점,921,741,180,685,236,683,238,89,79,75,83,83,87,79,83,86,84,93,34.1417004048583,202012
청사포로점,1271,1021,250,908,363,945,326,123,99,115,109,129,122,105,128,101,112,128,20.116552399608228,202012
태종로점,1187,985,202,873,314,884,303,102,124,105,103,103,117,119,103,109,92,110,34.19187817258883,202012
필문대로점,1183,961,222,897,286,878,305,134,116,95,108,110,91,113,90,96,99,131,34.95525494276795,202012
하남산단점,1028,847,181,790,238,766,262,92,88,97,91,107,100,99,91,89,77,97,34.05548996458087,202012
하리해안길점,1159,955,204,838,321,862,297,97,103,95,142,101,112,103,97,108,102,99,34.749738219895285,202012
하신번영로점,1515,1239,276,1144,371,1124,391,136,142,136,119,130,161,152,127,144,129,139,34.40193704600484,202012
하신중앙로점,1247,1026,221,900,347,927,320,125,96,126,116,123,104,109,119,96,108,125,34.44444444444444,202012
학감대로점,1434,1173,261,1082,352,1065,369,139,133,142,132,126,116,125,135,130,135,121,34.53282182438193,202012
학동로2점,1457,1208,249,1074,383,1080,377,148,132,128,132,139,123,122,132,140,141,120,34.265728476821195,202012
학동로점,1425,1179,246,1069,356,1056,369,125,138,154,126,144,104,143,107,111,136,137,34.458015267175576,202012
한남로점,1035,840,195,775,260,766,269,98,104,98,90,87,83,95,108,97,88,87,34.74761904761905,202012
한누리대로점,1295,1042,253,966,329,960,335,117,106,117,122,129,120,116,108,111,123,126,35.0489443378119,202012
한밭대로점,1093,889,204,818,275,811,282,102,92,108,96,94,97,101,114,90,105,94,48.255343082114734,202012
해안새벽시장길점,1253,1041,212,944,309,928,325,100,117,105,108,130,134,103,118,116,117,105,33.93756003842459,202012
해운대로점,1431,1170,261,1054,377,1065,366,142,153,153,119,139,109,127,136,128,123,102,34.702564102564104,202012
해운대해변로점,1026,837,189,736,290,762,264,100,101,88,99,85,96,80,94,100,88,95,20.38231780167264,202012
화곡로2점,1211,978,233,897,314,901,310,100,88,104,98,119,146,99,119,110,107,121,34.350715746421265,202012
화곡로점,1098,890,208,817,281,814,284,99,90,107,94,97,106,103,89,95,113,105,34.29775280898876,202012
화중로점,1181,937,244,847,334,873,308,100,122,102,117,109,99,93,111,109,115,104,35.013874066168626,202012
효덕로점,1325,1080,245,993,332,986,339,114,126,117,107,112,133,143,101,125,122,125,33.96666666666667,202012
효원로점,821,678,143,614,207,611,210,68,67,80,78,75,69,87,83,76,75,63,33.733038348082594,202012
가덕해안로점,1040,842,198,777,263,705,335,81,118,85,101,73,79,110,95,104,94,100,34.6021377672209,202101
가마산로2점,1519,1241,278,1123,396,1028,491,182,141,133,116,127,148,143,144,128,126,131,34.377115229653505,202101
가마산로점,1070,877,193,804,266,726,344,86,103,107,95,97,120,83,83,109,94,93,35.44127708095781,202101
감천항로점,1033,861,172,783,250,701,332,91,95,104,89,102,87,84,94,85,105,97,33.52845528455285,202101
강남대로2점,1128,927,201,831,297,762,366,116,100,89,98,112,100,113,105,88,103,104,35.44660194174757,202101
강남대로점,1104,906,198,803,301,748,356,105,103,88,103,101,85,119,116,94,97,93,34.57726269315673,202101
강남점3점,1311,1059,252,975,336,887,424,98,129,127,124,112,128,117,129,120,104,123,34.0547686496695,202101
경열로점,1181,961,220,871,310,796,385,109,103,126,111,99,109,116,103,110,103,92,34.02913631633715,202101
계룡로점,1434,1167,267,1053,381,970,464,127,124,148,128,147,134,126,119,144,117,120,34.12596401028278,202101
계족로점,1187,956,231,884,303,804,383,117,99,98,86,119,111,91,118,115,115,118,34.53033472803347,202101
고산자로2점,1431,1161,270,1073,358,970,461,126,129,134,141,122,155,119,132,127,138,108,34.26959517657192,202101
고산자로점,1059,841,218,767,292,716,343,101,100,105,78,93,102,87,102,101,91,99,35.38406658739596,202101
관악로2점,1464,1211,253,1061,403,993,471,135,122,145,122,130,154,133,125,138,128,132,34.69611890999174,202101
관악로점,1157,934,223,858,299,783,374,100,79,109,113,115,132,109,111,84,107,98,34.198072805139184,202101
관저동로점,1479,1202,277,1080,399,1007,472,124,118,148,151,132,129,139,138,140,136,124,34.816139767054906,202101
광산로점,1006,815,191,761,245,680,326,90,104,77,99,107,84,68,97,96,97,87,35.16073619631902,202101
광주여대길점,1256,1009,247,911,345,848,408,120,134,99,111,116,96,121,112,125,112,110,34.947472745292366,202101
구덕로점,1216,970,246,906,310,827,389,111,106,100,123,92,123,104,129,111,102,115,46.964948453608244,202101
구청로점,913,732,181,657,256,617,296,77,92,97,90,76,80,78,83,82,67,91,34.01092896174863,202101
국제금융로2점,760,605,155,568,192,515,245,64,65,68,74,68,63,64,65,62,88,79,48.51239669421488,202101
국제금융로점,1398,1114,284,1013,385,945,453,125,117,136,132,132,130,145,124,119,121,117,34.690305206463194,202101
금송로점,1300,1055,245,950,350,880,420,129,113,119,115,115,136,131,104,96,126,116,34.573459715639814,202101
금화로점,1346,1073,273,986,360,914,432,106,122,136,128,134,118,119,114,132,120,117,34.30848089468779,202101
기장대로점,1484,1215,269,1083,401,1005,479,124,135,138,140,149,118,136,121,129,129,165,34.873251028806585,202101
기흥점,1090,897,193,845,245,740,350,75,107,90,97,109,108,86,107,104,106,101,34.50613154960981,202101
낙동대로2점,1488,1196,292,1059,429,1008,480,150,139,130,132,133,115,154,142,137,121,135,34.75167224080268,202101
낙동대로점,1248,1013,235,918,330,844,404,116,113,126,103,121,123,126,99,101,109,111,33.79763079960513,202101
낙동북로점,1153,958,195,843,310,784,369,102,103,92,111,126,89,102,99,116,115,98,34.03757828810021,202101
남동남로점,1406,1130,276,1038,368,953,453,129,121,142,124,139,107,143,129,118,135,119,33.79557522123894,202101
남부순환로2점,1552,1252,300,1166,386,1047,505,131,144,164,140,161,159,139,151,139,114,110,34.186102236421725,202101
남부순환로점,1240,1002,238,924,316,836,404,142,113,106,104,115,108,115,99,104,114,120,35.09880239520958,202101
남천동로점,1009,814,195,747,262,683,326,99,97,85,95,91,82,89,94,89,98,90,34.714987714987714,202101
내방로점,1364,1130,234,991,373,926,438,127,131,125,107,123,121,123,133,118,121,135,20.21858407079646,202101
노해로2점,1670,1342,328,1242,428,1135,535,146,152,158,139,140,173,141,150,172,162,137,35.10283159463487,202101
노해로점,1218,974,244,877,341,827,391,110,108,96,125,111,103,109,113,118,115,110,34.893223819301845,202101
녹사평대로2점,1587,1288,299,1180,407,1076,511,138,136,162,161,127,138,135,149,142,131,168,34.47282608695652,202101
녹사평대로점,1394,1127,267,1019,375,948,446,141,119,115,127,124,131,122,116,115,155,129,34.109139307897074,202101
다대동로점,1456,1195,261,1124,332,984,472,139,115,120,118,139,137,144,141,145,123,135,34.42259414225941,202101
달맞이길점,1366,1097,269,1010,356,929,437,120,112,128,121,118,138,124,119,119,141,126,33.987237921604375,202101
당산로2점,1386,1118,268,1029,357,944,442,146,126,124,128,123,108,127,137,119,123,125,35.07871198568873,202101
당산로점,1094,865,229,788,306,743,351,101,100,95,95,102,99,99,104,97,85,117,47.58150289017341,202101
대둔산로점,1487,1201,286,1107,380,1006,481,123,142,119,146,149,127,159,148,146,119,109,34.30807660283097,202101
대전로점,1190,928,262,868,322,805,385,99,121,105,124,109,122,111,90,98,100,111,47.1239224137931,202101
대종로점,1512,1232,280,1122,390,1030,482,157,141,129,132,119,128,135,137,134,158,142,34.55113636363637,202101
대흥로점,842,685,157,633,209,573,269,76,85,81,70,71,75,76,80,68,78,82,34.97664233576642,202101
덕남길점,1339,1093,246,1009,330,908,431,112,130,123,118,106,126,131,147,117,98,131,34.93138151875572,202101
덕수궁길2점,1209,988,221,882,327,818,391,115,105,112,113,124,105,112,119,94,95,115,34.2914979757085,202101
덕수궁길점,1027,846,181,760,267,695,332,88,84,88,101,99,97,88,107,100,82,93,33.95862884160756,202101
도봉로2점,969,762,207,733,236,657,312,76,88,81,94,93,80,80,107,83,104,83,47.479002624671914,202101
도봉로점,1307,1090,217,975,332,883,424,130,126,119,100,137,117,106,111,115,127,119,34.758715596330276,202101
동구청로점,1330,1089,241,983,347,898,432,107,106,122,117,126,110,125,143,122,125,127,34.499540863177224,202101
둔산로점,1125,929,196,853,272,764,361,100,91,86,104,106,106,106,113,111,100,102,19.85037674919268,202101
둔산서로점,1187,966,221,857,330,806,381,109,115,98,109,126,115,104,122,98,102,89,34.02277432712215,202101
둔산중로점,1125,941,184,818,307,762,363,83,86,112,102,97,105,103,87,101,124,125,34.83209351753454,202101
르노삼성대로점,1095,886,209,807,288,743,352,94,92,100,111,94,100,115,97,90,99,103,35.35778781038375,202101
마들로2점,1065,857,208,797,268,721,344,88,90,104,92,106,89,107,85,103,92,109,35.329054842473745,202101
마들로점,1486,1219,267,1087,399,1010,476,129,121,136,136,142,125,149,139,137,142,130,34.78096800656276,202101
마린시티1로점,946,791,155,704,242,637,309,83,92,82,85,93,99,73,98,75,90,76,34.67003792667509,202101
마포대로2점,1377,1113,264,986,391,932,445,130,95,126,128,151,119,139,116,127,137,109,35.0125786163522,202101
마포대로점,1427,1173,254,1069,358,961,466,130,129,117,138,115,130,137,113,122,157,139,34.53452685421995,202101
망양로점,1367,1104,263,1030,337,924,443,133,139,118,111,123,125,137,122,131,111,117,34.48007246376812,202101
명지국제7로점,1186,960,226,886,300,808,378,119,120,91,103,115,101,107,104,107,128,91,34.27916666666667,202101
명지동점,1299,1083,216,973,326,883,416,127,123,102,128,100,128,133,94,111,126,127,35.1606648199446,202101
명지새동네길점,1191,995,196,910,281,807,384,112,106,88,117,108,132,97,104,105,115,107,34.70753768844221,202101
목공동로2점,1489,1216,273,1063,426,1007,482,139,137,135,148,140,137,139,110,123,144,137,34.016447368421055,202101
목공동로점,1185,946,239,849,336,806,379,116,103,114,133,114,119,90,86,103,117,90,47.02431289640592,202101
못골로점,1132,952,180,847,285,766,366,97,107,101,117,119,105,108,95,106,87,90,34.174369747899156,202101
무교로2점,1589,1272,317,1173,416,1075,514,149,144,148,128,155,159,124,122,159,147,154,34.602987421383645,202101
무교로점,878,725,153,632,246,593,285,62,73,87,84,82,73,82,84,89,65,97,33.41379310344828,202101
문예회관길점,1219,1007,212,884,335,823,396,111,127,125,113,106,104,118,101,96,118,100,20.779543197616682,202101
민락수변로점,1320,1069,251,947,373,895,425,119,97,123,98,111,114,121,138,132,150,117,34.724976613657624,202101
방죽로점,1244,1005,239,892,352,843,401,125,105,102,117,115,103,142,120,117,97,101,34.25273631840796,202101
배재로점,1523,1252,271,1140,383,1033,490,152,124,152,151,145,144,111,133,152,134,125,34.59584664536741,202101
법원로2점,1337,1100,237,989,348,904,433,128,117,116,132,120,137,114,109,129,116,119,34.19090909090909,202101
법원로점,2304,1907,397,1733,571,1556,748,176,254,198,206,214,212,237,210,201,193,203,35.257472469847926,202101
보문로2점,1092,893,199,796,296,742,350,99,98,98,99,102,95,102,101,108,92,98,35.68645016797313,202101
보문로점,1185,972,213,880,305,802,383,105,113,126,89,120,103,103,107,88,111,120,34.51543209876543,202101
복수서로점,908,743,165,676,232,614,294,88,79,73,93,104,74,87,72,85,75,78,34.681022880215345,202101
봉선로점,1180,959,221,891,289,796,384,110,110,95,96,127,108,116,110,105,98,105,33.19499478623566,202101
봉화산로2점,998,830,168,762,236,673,325,84,112,85,90,105,95,74,82,89,87,95,35.526506024096385,202101
봉화산로점,818,676,142,626,192,554,264,66,80,70,80,77,72,72,90,69,71,71,34.36538461538461,202101
부흥로점,1375,1106,269,1003,372,929,446,111,121,105,133,142,123,136,113,128,130,133,33.988245931283906,202101
북유성대로점,1310,1079,231,978,332,887,423,110,127,119,111,103,101,139,122,110,124,144,34.42261353104727,202101
분포로점,1551,1273,278,1139,412,1051,500,142,148,150,130,121,139,171,138,141,131,140,34.435192458758834,202101
비아로점,1551,1228,323,1170,381,1050,501,128,121,137,142,134,143,138,153,156,156,143,35.3485342019544,202101
사우중로점,1636,1329,307,1220,416,1108,528,145,142,157,151,158,133,148,143,160,142,157,34.88261851015801,202101
사직로2점,1034,844,190,769,265,704,330,97,86,98,99,87,109,78,73,105,104,98,34.34952606635071,202101
사직로점,2333,1909,424,1734,599,1582,751,247,197,195,223,208,207,210,212,207,221,206,34.50078575170246,202101
삼봉로2점,1370,1120,250,1025,345,927,443,130,119,115,131,128,105,137,130,127,128,120,34.35803571428571,202101
삼봉로점,1031,816,215,788,243,697,334,105,107,87,88,93,82,93,103,84,89,100,35.302696078431374,202101
삼일대로2점,1000,816,184,735,265,676,324,85,96,97,86,81,92,89,85,97,103,89,35.17524509803921,202101
삼일대로점,1203,979,224,890,313,821,382,105,111,128,111,111,105,106,121,94,117,94,34.61797752808989,202101
상무공원로점,1422,1142,280,1057,365,967,455,124,116,118,131,125,141,130,129,131,134,143,35.2784588441331,202101
상무대로점,1123,916,207,860,263,758,365,100,86,93,99,121,110,109,107,95,100,103,33.62882096069869,202101
상무번영로점,912,750,162,691,221,616,296,87,85,81,84,92,61,70,93,90,82,87,47.252,202101
서남로점,1119,924,195,815,304,755,364,96,110,105,100,92,95,96,102,114,90,119,34.56060606060606,202101
서소문로2점,1033,846,187,757,276,702,331,74,104,87,100,95,104,96,92,101,87,93,34.71394799054374,202101
서소문로점,1273,1047,226,935,338,861,412,119,108,119,117,112,138,109,110,116,100,125,34.0639923591213,202101
서초중앙로2점,1238,1011,227,914,324,842,396,121,108,122,113,115,112,96,107,113,112,119,35.132542037586546,202101
서초중앙로3점,1095,899,196,814,281,740,355,92,86,101,106,93,98,106,106,101,101,105,33.69299221357063,202101
서초중앙로점,1158,958,200,857,301,785,373,102,99,105,95,104,96,113,133,99,99,113,34.60125260960334,202101
서하로점,1549,1257,292,1161,388,1052,497,131,135,147,143,149,142,129,130,155,135,153,33.995226730310264,202101
석봉로점,846,697,149,618,228,570,276,54,85,68,72,89,73,90,74,80,78,83,33.86513629842181,202101
성남대로점,1541,1259,282,1123,418,1043,498,145,135,137,145,142,129,144,140,140,143,141,34.70055599682288,202101
성내로2점,1303,1062,241,998,305,886,417,117,135,134,113,123,98,126,96,136,117,108,34.410546139359695,202101
성내로점,967,764,203,707,260,658,309,65,86,100,74,92,81,94,96,96,90,93,48.81544502617801,202101
성산동2점,1362,1106,256,1010,352,921,441,144,119,120,112,121,119,119,129,126,117,136,34.77124773960217,202101
성산동점,1025,846,179,788,237,693,332,82,79,99,85,78,91,98,109,94,99,111,20.254137115839242,202101
세종대로2점,1059,878,181,779,280,719,340,108,93,108,89,88,99,106,80,102,91,95,34.207289293849655,202101
세종대로점,1187,984,203,887,300,806,381,96,129,117,106,101,113,109,97,115,105,99,34.34044715447155,202101
세종로점,1187,995,192,878,309,803,384,88,104,107,108,116,113,95,117,109,118,112,33.78090452261306,202101
송정공원로점,914,743,171,654,260,623,291,76,82,96,85,84,81,80,71,95,79,85,34.67698519515478,202101
송정해변로점,1584,1315,269,1156,428,1077,507,135,160,135,159,141,147,140,143,141,133,150,20.380228136882128,202101
시흥대로2점,1001,821,180,751,250,681,320,88,88,90,112,76,79,98,88,89,102,91,34.844092570036544,202101
시흥대로점,1246,1027,219,934,312,846,400,90,112,125,118,119,137,104,116,112,109,104,34.01363193768257,202101
신갈마로점,1192,988,204,885,307,809,383,98,107,103,135,117,104,97,108,113,97,113,34.8168016194332,202101
신일동로점,1373,1117,256,1031,342,931,442,93,130,128,131,112,134,123,136,129,120,137,33.88540734109221,202101
신일서로점,1274,1048,226,925,349,864,410,120,119,117,109,93,125,118,129,130,99,115,34.63835877862596,202101
안양천로2점,1155,964,191,867,288,779,376,118,96,93,94,100,110,118,110,109,96,111,34.55082987551867,202101
안양천로점,1217,985,232,892,325,823,394,100,103,118,111,130,109,106,111,115,109,105,34.52385786802031,202101
양재2점,1313,1075,238,979,334,889,424,129,122,114,105,137,122,119,107,110,139,109,34.10046511627907,202101
양재점,1221,1005,216,908,313,834,387,98,107,111,117,118,120,108,118,117,111,96,34.372139303482584,202101
어등대로점,1209,975,234,887,322,819,390,124,104,113,110,107,118,98,112,101,116,106,34.50871794871795,202101
엑스포로점,1129,922,207,839,290,764,365,111,100,103,85,113,93,121,100,101,115,87,34.07266811279826,202101
연제로점,1424,1153,271,1073,351,960,464,150,134,115,140,127,111,106,127,151,125,138,34.44319167389419,202101
연희로2점,1422,1159,263,1064,358,966,456,119,124,128,111,121,129,146,146,131,121,146,34.77480586712684,202101
연희로점,1104,905,199,826,278,749,355,105,122,104,126,85,86,117,93,79,80,107,35.55138121546961,202101
영통구점,1088,885,203,799,289,734,354,94,107,92,94,101,113,87,94,103,97,106,33.90847457627119,202101
예술길점,1186,964,222,919,267,807,379,101,119,106,92,108,117,117,112,124,105,85,34.25829875518672,202101
온천천로점,1577,1299,278,1198,379,1071,506,147,130,141,141,157,146,136,134,150,160,135,34.220169361046956,202101
올림픽로2점,1402,1160,242,1046,356,953,449,127,117,130,133,137,115,123,130,138,124,128,20.138793103448275,202101
올림픽로점,999,827,172,737,262,676,323,85,83,103,101,83,95,91,101,83,90,84,33.593712212817415,202101
용대로점,1057,874,183,784,273,712,345,94,98,109,97,107,88,92,95,93,96,88,35.075514874141874,202101
용아로점,1372,1121,251,1002,370,931,441,132,141,118,127,129,122,108,126,116,123,130,34.50223015165031,202101
용운동점,882,733,149,656,226,601,281,72,75,70,82,77,67,112,76,86,99,66,34.08867667121419,202101
우치로점,1158,948,210,883,275,783,375,114,96,109,103,115,99,92,117,95,103,115,48.29746835443038,202101
월계로2점,1031,828,203,762,269,697,334,98,92,96,104,89,86,91,93,102,89,91,34.655797101449274,202101
월계로점,1241,1033,208,920,321,840,401,111,104,133,102,120,117,115,107,104,111,117,19.964181994191676,202101
월드컵대로2점,915,751,164,673,242,619,296,89,85,83,87,94,61,97,82,84,73,80,34.93209054593875,202101
월드컵대로점,1142,928,214,841,301,772,370,108,102,92,121,77,109,92,116,98,119,108,34.01400862068966,202101
월드컵로2점,1428,1173,255,1041,387,966,462,114,133,116,107,162,142,151,122,138,124,119,34.969309462915604,202101
월드컵로점,946,754,192,724,222,643,303,77,74,102,86,79,78,91,92,98,90,79,33.54907161803713,202101
은평로2점,883,732,151,649,234,597,286,67,87,87,80,89,87,69,89,61,75,92,34.85792349726776,202101
은평로점,1248,1017,231,928,320,843,405,99,128,112,121,114,129,104,113,117,109,102,35.1661750245821,202101
일산동구점,1152,944,208,834,318,778,374,103,116,108,98,112,106,105,102,94,105,103,34.85699152542373,202101
자양로2점,1102,907,195,794,308,747,355,92,105,98,112,101,95,101,100,90,99,109,34.804851157662625,202101
자양로점,1186,970,216,877,309,803,383,114,124,106,107,80,109,105,106,117,94,124,34.21134020618557,202101
장대로점,1254,1020,234,920,334,849,405,117,135,98,114,114,123,115,108,100,110,120,34.76862745098039,202101
장동로점,1010,839,171,736,274,685,325,103,109,78,101,81,90,119,81,86,82,80,34.81287246722288,202101
장승배기로2점,1180,946,234,862,318,801,379,107,109,106,128,101,97,105,105,107,113,102,35.4661733615222,202101
장승배기로점,1151,958,193,833,318,782,369,110,106,92,105,95,113,111,84,114,120,101,20.650313152400834,202101
재반로점,1246,1035,211,893,353,844,402,112,103,115,117,104,119,119,112,130,109,106,34.32946859903382,202101
절영로점,1491,1245,246,1101,390,1007,484,134,141,120,155,152,108,132,135,128,148,138,34.27710843373494,202101
절재로점,1391,1124,267,1055,336,943,448,136,110,122,124,120,110,129,146,146,135,113,34.186832740213525,202101
제중로점,1184,964,220,859,325,803,381,105,103,113,94,105,122,123,95,108,109,107,34.08609958506224,202101
조치원점,1185,976,209,900,285,803,382,120,106,119,97,98,99,115,101,102,115,113,34.45696721311475,202101
종로2점,1551,1265,286,1154,397,1049,502,153,116,139,145,148,144,154,143,133,146,130,34.59288537549407,202101
종로점,1099,899,200,791,308,748,351,90,88,86,93,93,106,109,119,111,96,108,35.061179087875416,202101
준법로점,1150,927,223,861,289,779,371,111,94,121,106,112,98,98,109,100,108,93,35.441208198489754,202101
중구로점,1489,1213,276,1098,391,1008,481,148,146,130,133,139,117,138,123,129,155,131,34.45424567188788,202101
중동2로점,728,591,137,535,193,491,237,74,67,65,59,71,55,62,77,67,61,70,35.001692047377325,202101
중앙대로2점,1392,1146,246,1064,328,940,452,111,127,139,128,123,104,127,128,129,138,138,33.94938917975567,202101
중앙대로점,2252,1859,393,1662,590,1524,728,210,217,181,197,221,249,187,200,213,190,187,34.31898870360409,202101
증심사길점,1294,1066,228,949,345,875,419,105,125,103,103,135,120,99,141,139,106,118,35.26266416510319,202101
창경궁로2점,1453,1207,246,1064,389,986,467,139,146,124,106,154,126,125,144,135,139,115,34.64705882352941,202101
창경궁로점,1281,1043,238,931,350,867,414,117,99,100,121,118,107,140,131,99,126,123,35.04985618408437,202101
처인구점,1038,825,213,779,259,705,333,85,106,105,100,73,91,97,86,98,108,89,34.77212121212121,202101
천호대로2점,1576,1278,298,1135,441,1070,506,144,156,149,129,147,141,144,145,140,132,149,34.255868544600936,202101
천호대로점,1001,818,183,741,260,680,321,77,76,94,91,102,104,105,83,91,94,84,34.81173594132029,202101
첨단과기로점,1324,1076,248,967,357,900,424,131,117,131,119,109,136,124,126,122,97,112,34.85966542750929,202101
청계청로2점,1365,1123,242,1028,337,923,442,111,135,113,130,120,134,129,119,135,130,109,34.91807658058771,202101
청계청로점,909,744,165,686,223,615,294,64,93,83,86,92,84,91,88,73,76,79,34.55779569892473,202101
청사포로점,1271,1067,204,952,319,862,409,105,121,104,123,91,122,130,126,121,110,118,20.023430178069354,202101
태종로점,1182,967,215,885,297,801,381,115,119,113,108,109,99,106,111,99,97,106,33.93795243019648,202101
필문대로점,1190,957,233,872,318,810,380,129,93,126,88,101,119,118,98,131,92,95,34.69174503657262,202101
하남산단점,1028,820,208,784,244,700,328,91,86,83,103,95,104,88,99,83,100,96,34.8109756097561,202101
하리해안길점,1152,942,210,880,272,783,369,107,109,91,90,107,133,104,114,90,101,106,34.59235668789809,202101
하신번영로점,1523,1242,281,1125,398,1032,491,132,147,128,144,142,149,124,132,131,152,142,34.328502415458935,202101
하신중앙로점,1235,1018,217,901,334,832,403,111,110,113,101,91,119,89,128,127,117,129,34.7524557956778,202101
학감대로점,1420,1130,290,1048,372,967,453,108,146,120,129,121,135,119,134,119,155,134,34.6283185840708,202101
학동로2점,1453,1197,256,1105,348,989,464,150,129,109,141,143,126,133,129,128,125,140,34.443609022556394,202101
학동로점,1425,1149,276,1054,371,967,458,119,109,128,130,158,145,133,134,106,129,134,34.150565709312446,202101
한남로점,1038,850,188,787,251,705,333,99,87,85,100,112,86,112,83,82,108,84,33.35294117647059,202101
한누리대로점,1306,1063,243,992,314,887,419,126,118,111,111,132,116,114,114,103,125,136,34.78833490122295,202101
한밭대로점,1095,880,215,789,306,742,353,102,101,111,84,102,101,90,106,109,106,83,47.59318181818182,202101
해안새벽시장길점,1245,1004,241,916,329,843,402,119,121,114,112,99,121,110,117,114,106,112,33.97410358565737,202101
해운대로점,1427,1183,244,1075,352,965,462,119,123,131,132,125,137,121,152,125,127,135,33.75908706677937,202101
해운대해변로점,1040,882,158,769,271,704,336,93,89,95,95,102,92,116,87,94,93,84,20.028344671201815,202101
화곡로2점,1214,977,237,897,317,821,393,117,108,109,120,106,107,118,101,91,125,112,34.59263050153531,202101
화곡로점,1095,890,205,803,292,743,352,90,106,78,91,105,104,108,94,110,101,108,34.02247191011236,202101
화중로점,1182,956,226,869,313,801,381,121,98,119,96,110,105,105,106,98,113,111,34.37133891213389,202101
효덕로점,1333,1100,233,997,336,904,429,127,126,140,108,115,116,115,107,144,125,110,35.42,202101
효원로점,822,688,134,614,208,555,267,77,73,79,77,57,81,71,86,70,82,69,34.83720930232558,202101
가덕해안로점,935,781,154,696,239,668,267,78,87,88,89,69,87,82,88,108,84,75,33.916773367477596,202102
가마산로2점,1379,1128,251,1027,352,989,390,116,124,125,113,138,133,134,139,103,124,130,34.770390070921984,202102
가마산로점,950,748,202,696,254,679,271,78,80,91,89,72,96,85,94,81,97,87,34.901069518716575,202102
감천항로점,934,769,165,694,240,671,263,76,93,81,86,85,99,83,92,84,71,84,34.79323797139142,202102
강남대로2점,1018,835,183,759,259,727,291,92,85,94,99,81,84,94,103,97,84,105,33.25389221556886,202102
강남대로점,988,813,175,737,251,704,284,79,93,92,87,82,98,102,88,85,99,83,35.543665436654365,202102
강남점3점,1183,969,214,867,316,848,335,106,112,130,87,97,110,103,112,104,107,115,34.604747162022704,202102
경열로점,1075,873,202,807,268,766,309,102,103,92,102,93,97,82,99,102,103,100,35.269186712485684,202102
계룡로점,1297,1045,252,937,360,928,369,114,107,130,116,122,115,117,119,112,115,130,34.09952153110048,202102
계족로점,1071,882,189,751,320,769,302,91,105,100,93,94,104,95,103,79,114,93,34.52947845804989,202102
고산자로2점,1290,1062,228,934,356,922,368,114,115,123,141,108,119,116,112,110,115,117,34.21374764595104,202102
고산자로점,959,801,158,722,237,687,272,97,82,88,100,77,77,81,98,89,89,81,33.78651685393258,202102
관악로2점,1323,1053,270,952,371,945,378,128,124,116,111,110,139,115,125,110,135,110,33.85470085470085,202102
관악로점,1035,834,201,770,265,738,297,80,86,117,99,79,94,101,99,93,87,100,34.28417266187051,202102
관저동로점,1350,1083,267,1008,342,965,385,121,136,93,116,136,149,113,126,117,138,105,34.29732225300092,202102
광산로점,901,721,180,700,201,640,261,70,72,79,79,85,92,86,84,83,83,88,34.49514563106796,202102
광주여대길점,1123,925,198,817,306,804,319,106,96,91,104,100,110,106,102,115,96,97,34.33405405405406,202102
구덕로점,1091,879,212,819,272,777,314,112,107,95,96,91,84,104,93,84,103,122,48.640500568828216,202102
구청로점,820,679,141,608,212,588,232,90,73,70,70,79,83,63,69,75,79,69,34.801178203240056,202102
국제금융로2점,687,561,126,480,207,491,196,65,59,55,56,59,69,55,71,59,67,72,46.37967914438503,202102
국제금융로점,1262,1028,234,927,335,897,365,123,112,105,124,104,110,114,112,112,105,141,34.6284046692607,202102
금송로점,1184,966,218,869,315,844,340,116,99,110,120,119,90,100,101,119,98,112,34.43478260869565,202102
금화로점,1203,982,221,878,325,858,345,114,130,117,107,104,105,106,108,95,109,108,35.28513238289206,202102
기장대로점,1349,1084,265,1020,329,967,382,128,121,124,141,116,114,107,116,131,135,116,34.132841328413285,202102
기흥점,988,798,190,710,278,703,285,88,96,79,90,89,88,91,95,100,67,105,34.09398496240601,202102
낙동대로2점,1344,1099,245,1002,342,957,387,131,112,124,136,119,108,119,120,118,150,107,34.212920837124656,202102
낙동대로점,1123,925,198,820,303,800,323,96,106,91,112,113,99,110,98,110,95,93,35.10594594594595,202102
낙동북로점,1043,838,205,758,285,741,302,85,84,97,93,92,108,100,98,92,103,91,34.488066825775654,202102
남동남로점,1257,1025,232,943,314,895,362,120,123,118,106,114,99,123,110,110,114,120,34.86243902439024,202102
남부순환로2점,1403,1130,273,1052,351,1000,403,88,108,136,143,134,144,120,127,127,154,122,34.24867256637168,202102
남부순환로점,1123,896,227,810,313,803,320,103,114,109,90,105,93,91,112,97,104,105,34.546875,202102
남천동로점,905,737,168,670,235,649,256,78,84,80,78,83,81,85,89,73,77,97,34.71777476255088,202102
내방로점,1238,1000,238,913,325,885,353,104,106,116,124,122,108,106,135,94,112,111,20.059,202102
노해로2점,1505,1240,265,1080,425,1078,427,156,134,133,134,129,136,127,133,161,108,154,35.020161290322584,202102
노해로점,1092,921,171,824,268,776,316,97,83,101,93,114,89,103,95,94,108,115,34.19543973941368,202102
녹사평대로2점,1427,1144,283,1055,372,1023,404,145,137,129,124,133,121,124,138,128,112,136,34.23863636363637,202102
녹사평대로점,1256,1033,223,957,299,898,358,111,115,127,127,116,110,119,104,97,113,117,34.79090029041626,202102
다대동로점,1319,1075,244,961,358,940,379,128,123,127,124,135,113,128,120,102,104,115,34.53674418604651,202102
달맞이길점,1231,989,242,920,311,879,352,114,113,104,105,121,120,118,101,100,121,114,33.95348837209303,202102
당산로2점,1262,1024,238,911,351,902,360,125,101,107,120,102,119,132,124,115,106,111,34.51953125,202102
당산로점,982,782,200,744,238,701,281,90,87,92,80,91,96,96,98,90,80,82,47.00255754475703,202102
대둔산로점,1346,1112,234,1039,307,961,385,129,106,124,107,123,113,129,115,124,140,136,34.77607913669065,202102
대전로점,1074,863,211,797,277,767,307,100,105,81,85,89,106,94,100,102,98,114,47.60139049826188,202102
대종로점,1383,1118,265,1037,346,983,400,141,112,124,128,113,124,123,102,135,137,144,34.1824686940966,202102
대흥로점,767,632,135,581,186,549,218,66,60,67,68,83,66,52,70,76,78,81,33.550632911392405,202102
덕남길점,1213,1008,205,893,320,870,343,117,111,111,115,95,97,116,100,119,110,122,34.492063492063494,202102
덕수궁길2점,1094,903,191,836,258,784,310,93,114,85,94,106,105,99,90,106,100,102,34.29568106312292,202102
덕수궁길점,929,756,173,696,233,664,265,88,93,81,62,77,95,91,97,82,65,98,34.60978835978836,202102
도봉로2점,874,720,154,651,223,624,250,82,70,78,81,72,85,87,84,76,77,82,48.294444444444444,202102
도봉로점,1174,963,211,841,333,835,339,112,107,102,111,104,104,113,100,106,110,105,34.346832814122536,202102
동구청로점,1205,979,226,893,312,861,344,101,107,116,113,90,127,121,124,103,109,94,34.4126659856997,202102
둔산로점,1018,846,172,751,267,729,289,99,98,88,99,83,95,98,86,85,89,98,19.986997635933808,202102
둔산서로점,1075,873,202,799,276,769,306,96,97,87,98,108,114,85,102,89,104,95,33.35509736540664,202102
둔산중로점,1018,832,186,733,285,729,289,79,96,94,102,87,87,103,92,92,104,82,35.09615384615385,202102
르노삼성대로점,981,794,187,710,271,699,282,85,70,81,96,94,96,95,86,92,92,94,34.424433249370274,202102
마들로2점,964,797,167,723,241,690,274,79,84,95,91,77,81,95,79,94,103,86,33.750313676286076,202102
마들로점,1344,1095,249,968,376,960,384,112,139,126,112,129,121,108,126,102,121,148,34.31689497716895,202102
마린시티1로점,853,700,153,635,218,609,244,67,67,82,85,66,81,76,83,73,85,88,35.417142857142856,202102
마포대로2점,1233,1001,232,938,295,878,355,103,123,120,93,88,140,94,115,116,129,112,34.57042957042957,202102
마포대로점,1292,1036,256,959,333,924,368,119,118,106,131,121,112,121,125,122,115,102,34.17567567567568,202102
망양로점,1234,1020,214,900,334,887,347,114,104,118,107,116,110,121,108,108,107,121,34.687254901960785,202102
명지국제7로점,1063,837,226,784,279,763,300,100,84,109,109,100,111,93,98,83,85,91,34.08482676224612,202102
명지동점,1180,959,221,869,311,843,337,91,102,116,107,91,130,118,126,94,100,105,33.824817518248175,202102
명지새동네길점,1062,855,207,791,271,757,305,109,107,93,98,101,95,81,89,95,98,96,33.66432748538012,202102
목공동로2점,1342,1106,236,975,367,955,387,118,110,126,117,119,144,110,135,140,119,104,34.07142857142857,202102
목공동로점,1069,870,199,808,261,762,307,93,97,91,102,93,106,87,109,94,101,96,47.49540229885057,202102
못골로점,1013,816,197,750,263,724,289,89,108,85,83,93,77,85,89,107,94,103,34.51960784313726,202102
무교로2점,1430,1170,260,1067,363,1025,405,110,138,112,144,136,116,137,128,142,120,147,34.55641025641026,202102
무교로점,789,637,152,570,219,564,225,71,65,78,75,60,80,85,78,68,60,69,35.21350078492936,202102
문예회관길점,1107,911,196,842,265,791,316,116,91,90,112,96,100,89,110,86,98,119,20.51152579582876,202102
민락수변로점,1186,968,218,874,312,846,340,108,120,109,96,103,103,118,117,107,108,97,34.55268595041322,202102
방죽로점,1128,917,211,831,297,804,324,90,103,115,110,95,99,103,103,104,102,104,34.42420937840785,202102
배재로점,1373,1120,253,1025,348,978,395,119,126,117,116,124,124,127,145,113,149,113,33.25089285714286,202102
법원로2점,1207,995,212,928,279,863,344,114,110,115,113,120,109,106,118,93,100,109,34.436180904522615,202102
법원로점,2097,1708,389,1590,507,1498,599,217,169,194,199,180,205,179,179,200,209,166,34.05913348946136,202102
보문로2점,993,823,170,739,254,708,285,85,102,94,86,81,77,86,102,101,91,88,35.0498177399757,202102
보문로점,1069,877,192,767,302,760,309,90,112,94,88,97,95,89,107,120,93,84,34.506271379703534,202102
복수서로점,827,676,151,639,188,593,234,74,88,75,72,78,76,73,80,68,79,64,35.40976331360947,202102
봉선로점,1071,861,210,797,274,766,305,108,91,92,107,100,101,104,91,94,94,89,34.508710801393725,202102
봉화산로2점,911,731,180,693,218,650,261,94,66,81,84,80,76,89,86,78,81,96,33.99589603283174,202102
봉화산로점,731,592,139,548,183,522,209,65,66,69,70,63,68,66,69,73,59,63,35.5152027027027,202102
부흥로점,1231,1017,214,915,316,884,347,117,112,135,113,101,105,99,111,103,114,121,34.46705998033432,202102
북유성대로점,1179,970,209,859,320,841,338,94,111,106,120,87,125,101,109,98,112,116,34.42371134020618,202102
분포로점,1391,1143,248,1031,360,993,398,116,131,129,135,124,130,142,122,126,114,122,34.0,202102
비아로점,1395,1137,258,1040,355,996,399,119,108,127,140,132,144,100,120,115,166,124,34.47053649956025,202102
사우중로점,1486,1228,258,1095,391,1060,426,139,162,137,140,130,155,126,116,134,124,123,34.759771986970684,202102
사직로2점,936,780,156,690,246,667,269,79,79,83,93,75,92,81,95,92,85,82,34.562820512820515,202102
사직로점,2115,1740,375,1589,526,1511,604,192,182,190,203,202,221,183,171,187,183,201,34.05862068965517,202102
삼봉로2점,1228,1002,226,907,321,873,355,105,127,115,107,106,105,120,109,116,107,111,35.13572854291417,202102
삼봉로점,941,770,171,694,247,671,270,69,100,75,102,88,93,68,89,92,79,86,33.65844155844156,202102
삼일대로2점,903,746,157,667,236,644,259,89,81,87,91,77,80,78,95,76,80,69,34.6260053619303,202102
삼일대로점,1096,900,196,813,283,782,314,89,88,104,98,93,106,104,102,121,88,103,33.83777777777778,202102
상무공원로점,1281,1047,234,945,336,912,369,108,91,114,111,115,126,123,111,130,123,129,34.84909264565425,202102
상무대로점,1016,842,174,753,263,722,294,106,93,95,86,89,99,95,92,85,88,88,35.219714964370546,202102
상무번영로점,830,664,166,612,218,592,238,87,58,74,82,78,67,72,75,72,65,100,46.95933734939759,202102
서남로점,1020,838,182,747,273,727,293,93,95,87,98,97,99,101,72,100,88,90,34.457040572792366,202102
서소문로2점,939,756,183,688,251,672,267,84,78,80,82,87,64,92,84,101,88,99,33.948412698412696,202102
서소문로점,1151,943,208,853,298,821,330,100,95,116,105,84,122,110,113,98,110,98,34.30010604453871,202102
서초중앙로2점,1128,927,201,824,304,808,320,91,103,114,79,114,117,102,97,103,99,109,34.33009708737864,202102
서초중앙로3점,985,828,157,729,256,708,277,86,89,90,95,102,94,102,89,75,67,96,34.90338164251208,202102
서초중앙로점,1038,852,186,766,272,741,297,98,97,85,96,105,97,102,89,76,96,97,34.478873239436616,202102
서하로점,1395,1124,271,1054,341,996,399,113,131,144,121,136,128,147,104,133,125,113,34.16548042704626,202102
석봉로점,767,614,153,556,211,547,220,63,55,77,79,70,64,73,59,76,74,77,33.954397394136805,202102
성남대로점,1401,1133,268,1034,367,1000,401,113,130,142,137,115,117,123,137,132,132,123,34.66460723742277,202102
성내로2점,1180,976,204,871,309,842,338,84,116,109,118,116,102,104,96,123,96,116,35.50922131147541,202102
성내로점,876,706,170,632,244,627,249,85,87,83,80,91,61,80,73,74,79,83,47.51558073654391,202102
성산동2점,1239,1004,235,932,307,884,355,82,115,120,144,81,128,129,95,119,105,121,34.52290836653386,202102
성산동점,943,793,150,685,258,672,271,81,84,84,76,103,77,95,93,80,84,86,20.36191677175284,202102
세종대로2점,960,790,170,709,251,688,272,99,68,116,83,70,76,90,100,84,83,91,34.57974683544304,202102
세종대로점,1069,859,210,788,281,762,307,104,88,102,106,94,86,96,88,97,97,111,34.670547147846335,202102
세종로점,1078,861,217,797,281,769,309,98,96,109,99,105,101,102,89,90,101,88,34.94889663182346,202102
송정공원로점,820,646,174,622,198,585,235,75,89,78,73,70,76,74,75,72,60,78,34.85139318885449,202102
송정해변로점,1421,1170,251,1041,380,1015,406,137,115,118,138,137,116,123,117,145,133,142,20.596581196581198,202102
시흥대로2점,903,744,159,663,240,642,261,86,81,92,59,83,72,83,85,90,84,88,35.723118279569896,202102
시흥대로점,1124,934,190,858,266,801,323,104,111,108,112,104,93,101,91,89,101,110,34.389721627408996,202102
신갈마로점,1066,873,193,798,268,760,306,97,103,97,82,91,94,104,108,97,101,92,35.39747995418099,202102
신일동로점,1233,1007,226,911,322,881,352,120,111,103,120,123,115,110,101,112,107,111,34.66931479642503,202102
신일서로점,1157,942,215,860,297,825,332,104,98,84,121,107,103,112,115,93,101,119,33.96390658174098,202102
안양천로2점,1047,861,186,752,295,748,299,89,109,74,93,106,89,103,81,104,97,102,34.78861788617886,202102
안양천로점,1094,891,203,794,300,781,313,97,92,100,116,108,105,94,106,85,93,98,34.9057239057239,202102
양재2점,1172,936,236,875,297,838,334,106,99,124,112,114,117,102,87,103,98,110,34.17948717948718,202102
양재점,1091,891,200,781,310,779,312,95,105,100,100,101,111,108,90,97,99,85,34.462401795735126,202102
어등대로점,1108,935,173,812,296,791,317,91,93,91,104,91,125,100,107,94,110,102,34.510160427807484,202102
엑스포로점,1020,839,181,757,263,726,294,90,92,102,96,108,85,87,75,97,98,90,35.14064362336114,202102
연제로점,1295,1032,263,960,335,925,370,117,128,120,124,127,117,112,120,118,113,99,35.03294573643411,202102
연희로2점,1286,1051,235,951,335,917,369,116,118,110,116,137,120,115,127,103,116,108,34.33396764985728,202102
연희로점,991,787,204,738,253,708,283,94,94,83,97,65,91,99,87,97,86,98,34.899618805590855,202102
영통구점,985,811,174,722,263,703,282,79,92,100,83,69,90,82,92,110,88,100,33.88532675709001,202102
예술길점,1063,878,185,798,265,758,305,96,95,83,104,94,87,96,117,85,102,104,33.76537585421412,202102
온천천로점,1435,1152,283,1081,354,1024,411,139,139,120,137,116,141,120,138,125,122,138,34.518229166666664,202102
올림픽로2점,1260,1046,214,942,318,899,361,106,114,121,118,119,96,115,128,117,113,113,19.977055449330784,202102
올림픽로점,912,752,160,688,224,654,258,66,86,82,77,82,87,86,91,70,97,88,35.284574468085104,202102
용대로점,957,761,196,694,263,684,273,89,71,87,88,97,89,79,92,77,93,95,34.03285151116951,202102
용아로점,1232,1031,201,916,316,882,350,112,94,124,116,111,97,116,111,104,126,121,34.54607177497575,202102
용운동점,802,674,128,585,217,573,229,72,73,67,69,76,75,61,74,76,93,66,34.333827893175076,202102
우치로점,1040,830,210,767,273,742,298,96,109,108,88,91,89,97,85,88,98,91,47.48433734939759,202102
월계로2점,932,770,162,668,264,671,261,66,92,92,84,96,90,79,88,76,72,97,35.127272727272725,202102
월계로점,1120,939,181,807,313,800,320,98,100,113,104,102,104,95,97,105,102,100,20.623003194888177,202102
월드컵대로2점,826,658,168,621,205,591,235,73,77,72,82,67,81,75,89,56,65,89,33.60030395136778,202102
월드컵대로점,1038,855,183,781,257,743,295,93,89,72,91,98,122,100,99,82,101,91,33.74502923976608,202102
월드컵로2점,1286,1041,245,919,367,918,368,111,115,100,123,111,120,124,126,130,112,114,34.62439961575408,202102
월드컵로점,855,688,167,638,217,610,245,79,74,90,73,72,68,74,80,85,78,82,34.66424418604651,202102
은평로2점,789,647,142,558,231,561,228,65,82,82,74,74,69,65,68,73,60,77,34.519319938176196,202102
은평로점,1130,945,185,844,286,807,323,99,97,108,81,104,117,112,106,105,87,114,34.23915343915344,202102
일산동구점,1039,845,194,755,284,749,290,104,95,69,88,90,92,108,98,92,89,114,34.857988165680474,202102
자양로2점,984,799,185,752,232,702,282,86,88,98,88,78,93,94,97,96,90,76,34.28035043804756,202102
자양로점,1071,863,208,790,281,768,303,103,96,103,96,94,97,103,96,95,93,95,34.485515643105444,202102
장대로점,1127,912,215,834,293,801,326,100,101,95,107,98,129,91,108,113,87,98,33.75,202102
장동로점,909,740,169,684,225,649,260,90,80,75,80,92,81,86,92,78,75,80,33.79189189189189,202102
장승배기로2점,1073,883,190,784,289,767,306,119,94,118,94,99,96,89,89,87,97,91,35.214043035107586,202102
장승배기로점,1048,865,183,773,275,747,301,102,86,102,96,101,106,88,76,84,94,113,20.491329479768787,202102
재반로점,1128,927,201,828,300,805,323,86,87,95,103,115,116,109,104,94,115,104,34.264293419633226,202102
절영로점,1339,1077,262,999,340,955,384,135,130,134,117,122,135,119,116,103,115,113,34.29619312906221,202102
절재로점,1270,1041,229,929,341,909,361,121,121,129,110,117,118,113,106,105,116,114,34.69740634005764,202102
제중로점,1076,875,201,805,271,769,307,97,104,106,94,89,92,103,97,91,109,94,34.481142857142856,202102
조치원점,1077,917,160,805,272,770,307,88,84,105,111,116,101,98,83,102,83,106,34.50163576881134,202102
종로2점,1408,1138,270,1045,363,1012,396,144,111,124,128,133,113,115,139,125,144,132,35.011423550087876,202102
종로점,990,808,182,755,235,709,281,103,99,83,85,94,82,84,88,89,97,86,34.76980198019802,202102
준법로점,1035,851,184,770,265,745,290,90,86,93,101,94,96,96,87,104,105,83,32.93537015276146,202102
중구로점,1350,1107,243,993,357,962,388,131,110,107,118,126,115,119,135,159,99,131,34.50135501355014,202102
중동2로점,653,530,123,501,152,464,189,68,50,68,56,73,47,46,59,62,64,60,33.571698113207546,202102
중앙대로2점,1265,1023,242,925,340,903,362,103,114,114,112,112,112,117,113,128,115,125,34.33724340175953,202102
중앙대로점,2032,1681,351,1506,526,1454,578,197,171,160,180,169,185,210,174,191,191,204,34.3634741225461,202102
증심사길점,1177,968,209,890,287,841,336,111,107,126,112,95,89,103,108,124,107,95,35.1198347107438,202102
창경궁로2점,1325,1060,265,981,344,947,378,117,120,121,119,119,121,116,98,123,124,147,35.11698113207547,202102
창경궁로점,1143,935,208,820,323,816,327,102,92,120,92,105,105,100,110,97,118,102,34.037433155080215,202102
처인구점,936,776,160,705,231,669,267,80,100,81,90,82,82,85,69,77,83,107,35.347938144329895,202102
천호대로2점,1428,1165,263,1077,351,1018,410,126,124,128,121,141,134,122,139,128,138,127,33.53991416309013,202102
천호대로점,910,747,163,673,237,648,262,72,86,84,95,84,71,82,93,95,69,79,34.61311914323962,202102
첨단과기로점,1204,966,238,882,322,859,345,117,115,104,100,109,117,104,100,104,134,100,34.68633540372671,202102
청계청로2점,1239,1002,237,891,348,884,355,112,96,89,115,126,124,126,122,106,115,108,34.0439121756487,202102
청계청로점,825,656,169,616,209,590,235,96,58,96,86,79,72,56,70,65,73,74,35.114329268292686,202102
청사포로점,1150,963,187,868,282,826,324,111,100,114,111,111,102,103,75,107,107,109,20.358255451713397,202102
태종로점,1075,897,178,798,277,765,310,112,94,91,92,104,115,90,92,100,102,83,34.45373467112598,202102
필문대로점,1072,853,219,781,291,767,305,106,97,102,90,103,103,92,101,88,87,103,35.13716295427901,202102
하남산단점,938,775,163,701,237,670,268,79,90,97,84,98,81,73,93,92,75,76,33.861935483870965,202102
하리해안길점,1041,843,198,778,263,744,297,91,90,102,105,96,119,75,88,103,93,79,34.70818505338078,202102
하신번영로점,1378,1152,226,1004,374,985,393,128,111,125,128,128,130,143,118,125,123,119,34.37934027777778,202102
하신중앙로점,1128,918,210,812,316,805,323,96,118,108,106,105,83,122,92,101,97,100,34.37472766884532,202102
학감대로점,1286,1052,234,946,340,919,367,120,121,118,119,131,108,122,125,99,116,107,34.40494296577947,202102
학동로2점,1320,1083,237,993,327,943,377,111,127,119,148,114,141,99,122,118,96,125,35.45983379501385,202102
학동로점,1295,1073,222,948,347,925,370,103,118,144,112,115,121,119,108,121,123,111,34.525629077353216,202102
한남로점,940,781,159,700,240,672,268,90,80,94,75,107,75,89,68,85,94,83,33.829705505761844,202102
한누리대로점,1185,950,235,868,317,846,339,101,127,118,107,116,92,112,113,91,99,109,34.816842105263156,202102
한밭대로점,992,798,194,720,272,707,285,111,89,75,76,95,90,92,98,80,102,84,47.37719298245614,202102
해안새벽시장길점,1125,919,206,837,288,806,319,103,90,98,107,122,99,110,105,106,88,97,34.87268770402611,202102
해운대로점,1289,1060,229,985,304,922,367,128,122,107,110,110,134,127,101,110,119,121,35.259433962264154,202102
해운대해변로점,941,783,158,686,255,673,268,87,71,84,89,81,79,72,92,86,116,84,19.587484035759896,202102
화곡로2점,1103,902,201,808,295,787,316,89,102,108,90,99,109,118,84,90,109,105,34.37361419068736,202102
화곡로점,989,800,189,722,267,705,284,94,102,80,88,93,85,84,99,91,90,83,34.0625,202102
화중로점,1072,863,209,791,281,763,309,105,86,94,85,96,99,101,114,84,100,108,34.94785631517961,202102
효덕로점,1205,976,229,918,287,864,341,107,120,113,116,122,93,108,113,116,99,98,33.84836065573771,202102
효원로점,738,611,127,555,183,527,211,75,56,76,60,71,61,66,57,64,78,74,34.39279869067103,202102
가덕해안로점,1032,844,188,774,258,771,261,88,100,101,98,98,97,101,85,84,90,90,34.21800947867298,202103
가마산로2점,1511,1234,277,1141,370,1123,388,142,110,109,137,145,162,140,137,145,141,143,34.80551053484603,202103
가마산로점,1065,861,204,782,283,789,276,103,107,89,82,119,79,92,95,85,109,105,34.49941927990709,202103
감천항로점,1025,821,204,750,275,756,269,91,93,104,88,84,92,94,88,80,109,102,33.64799025578563,202103
강남대로2점,1121,893,228,824,297,830,291,92,107,115,94,92,119,103,94,87,104,114,34.139977603583425,202103
강남대로점,1091,893,198,840,251,809,282,126,100,103,101,105,83,77,103,104,91,98,33.961926091825305,202103
강남점3점,1305,1067,238,974,331,970,335,115,124,112,134,111,114,141,107,117,113,117,34.511715089034674,202103
경열로점,1182,968,214,872,310,877,305,112,107,98,120,108,114,101,106,96,118,102,34.27272727272727,202103
계룡로점,1429,1188,241,1036,393,1059,370,146,126,140,155,112,125,105,135,146,122,117,34.178451178451176,202103
계족로점,1191,956,235,875,316,884,307,114,116,114,92,104,110,106,108,118,99,110,35.29707112970711,202103
고산자로2점,1428,1201,227,1044,384,1059,369,125,113,124,116,121,151,126,141,137,142,132,34.11074104912573,202103
고산자로점,1066,873,193,806,260,791,275,96,105,82,108,97,81,96,109,91,102,99,35.09278350515464,202103
관악로2점,1455,1192,263,1071,384,1076,379,123,150,127,159,147,131,99,138,124,132,125,34.34395973154363,202103
관악로점,1164,948,216,877,287,864,300,124,111,107,96,90,106,117,105,93,100,115,34.39873417721519,202103
관저동로점,1498,1225,273,1098,400,1113,385,163,137,120,132,131,139,136,133,132,157,118,34.21469387755102,202103
광산로점,1003,813,190,734,269,745,258,92,95,98,89,94,88,83,94,95,82,93,34.85239852398524,202103
광주여대길점,1247,1031,216,907,340,925,322,120,99,113,132,122,110,107,115,103,128,98,33.80989330746848,202103
구덕로점,1219,983,236,916,303,903,316,100,103,94,118,110,122,113,118,109,123,109,47.14649033570702,202103
구청로점,915,756,159,676,239,682,233,81,102,87,84,96,67,76,83,80,81,78,33.82539682539682,202103
국제금융로2점,760,609,151,566,194,564,196,59,70,66,59,63,75,84,66,70,76,72,47.893267651888344,202103
국제금융로점,1400,1145,255,1061,339,1039,361,129,124,137,129,135,124,118,138,125,102,139,33.86724890829694,202103
금송로점,1308,1079,229,962,346,971,337,132,130,126,114,124,105,115,105,136,124,97,34.091751621872106,202103
금화로점,1335,1115,220,1002,333,988,347,130,128,132,137,116,122,101,108,112,112,137,33.814349775784756,202103
기장대로점,1488,1213,275,1094,394,1105,383,135,147,142,125,131,147,140,115,137,120,149,34.810387469084915,202103
기흥점,1094,881,213,820,274,811,283,106,98,110,100,99,100,93,101,103,96,88,34.30419977298524,202103
낙동대로2점,1493,1204,289,1108,385,1107,386,135,126,136,139,139,151,155,125,133,130,124,34.96594684385382,202103
낙동대로점,1246,1008,238,948,298,922,324,98,104,131,119,99,114,130,112,114,104,121,34.13789682539682,202103
낙동북로점,1154,939,215,867,287,858,296,96,122,102,113,104,111,101,94,102,115,94,34.48349307774228,202103
남동남로점,1385,1128,257,1059,326,1026,359,124,124,137,136,123,127,118,128,119,118,131,34.35283687943262,202103
남부순환로2점,1545,1258,287,1151,394,1150,395,137,135,148,147,125,134,145,160,148,124,142,34.22178060413354,202103
남부순환로점,1254,1017,237,943,311,931,323,114,131,118,111,117,101,132,103,94,109,124,34.76401179941003,202103
남천동로점,1007,845,162,730,277,751,256,87,90,100,90,90,101,83,105,97,91,73,33.8189349112426,202103
내방로점,1369,1167,202,1014,355,1016,353,130,124,103,141,142,115,115,115,116,136,132,20.434447300771208,202103
노해로2점,1678,1374,304,1260,418,1248,430,150,156,144,162,131,140,157,166,159,160,153,34.475254730713246,202103
노해로점,1212,1002,210,904,308,901,311,108,117,106,123,114,128,105,124,93,94,100,34.93313373253493,202103
녹사평대로2점,1591,1300,291,1170,421,1178,413,137,117,147,143,162,147,154,156,149,150,129,35.253846153846155,202103
녹사평대로점,1396,1141,255,1021,375,1031,365,143,129,124,114,126,121,131,128,121,116,143,34.008764241893076,202103
다대동로점,1449,1192,257,1092,357,1080,369,115,139,119,121,129,154,110,152,138,139,133,34.605704697986575,202103
달맞이길점,1367,1134,233,999,368,1017,350,125,138,106,116,136,124,101,131,119,143,128,34.454144620811284,202103
당산로2점,1407,1151,256,1079,328,1046,361,133,109,123,109,127,154,145,137,124,125,121,34.137271937445696,202103
당산로점,1096,886,210,804,292,811,285,101,89,96,94,119,110,84,89,112,103,99,47.68058690744921,202103
대둔산로점,1493,1214,279,1109,384,1110,383,143,130,144,131,127,126,123,132,153,137,147,34.112850082372326,202103
대전로점,1183,967,216,846,337,876,307,101,97,105,107,103,127,115,125,105,105,93,48.58014477766287,202103
대종로점,1516,1248,268,1137,379,1124,392,110,138,151,157,141,122,132,142,147,132,144,35.076121794871796,202103
대흥로점,852,704,148,602,250,631,221,78,83,69,69,83,80,77,84,75,84,70,34.95028409090909,202103
덕남길점,1336,1094,242,970,366,995,341,130,139,122,125,131,106,114,124,121,103,121,34.24131627056673,202103
덕수궁길2점,1209,1007,202,891,318,894,315,99,117,106,95,126,115,109,108,123,112,99,35.254220456802386,202103
덕수궁길점,1036,840,196,777,259,768,268,102,85,90,97,76,89,87,109,106,97,98,34.46785714285714,202103
도봉로2점,973,781,192,724,249,724,249,90,87,78,107,80,82,102,96,90,81,80,48.0371318822023,202103
도봉로점,1300,1068,232,981,319,965,335,119,106,122,131,113,107,121,130,122,128,101,34.97752808988764,202103
동구청로점,1339,1089,250,1002,337,997,342,120,117,114,119,127,123,128,129,118,117,127,34.1505968778696,202103
둔산로점,1121,943,178,815,306,831,290,98,111,100,108,97,101,112,96,97,99,102,20.33510074231177,202103
둔산서로점,1192,980,212,890,302,885,307,106,102,88,117,101,108,107,127,106,118,112,34.984693877551024,202103
둔산중로점,1123,907,216,841,282,833,290,107,90,97,107,83,107,95,121,118,105,93,35.32304299889746,202103
르노삼성대로점,1086,896,190,814,272,805,281,98,106,93,91,92,109,90,113,97,102,95,34.783482142857146,202103
마들로2점,1063,888,175,767,296,790,273,96,95,90,97,88,93,111,103,95,100,95,33.0777027027027,202103
마들로점,1497,1187,310,1101,396,1110,387,155,140,141,124,146,136,128,114,148,119,146,34.551811288963776,202103
마린시티1로점,943,774,169,698,245,698,245,77,87,77,83,70,96,92,91,89,92,89,34.36821705426357,202103
마포대로2점,1364,1118,246,1002,362,1013,351,136,130,132,100,126,135,107,119,122,119,138,34.50447227191413,202103
마포대로점,1433,1147,286,1066,367,1065,368,126,122,122,144,157,105,157,117,116,131,136,35.54664341761116,202103
망양로점,1372,1118,254,1010,362,1020,352,118,127,140,139,122,140,119,111,121,127,108,35.55724508050089,202103
명지국제7로점,1188,978,210,913,275,880,308,112,97,118,114,105,99,104,130,111,118,80,34.08895705521472,202103
명지동점,1305,1067,238,938,367,973,332,120,123,114,125,124,119,121,126,90,124,119,34.146204311152765,202103
명지새동네길점,1176,972,204,884,292,870,306,111,100,117,107,106,112,95,98,106,100,124,33.90946502057613,202103
목공동로2점,1482,1184,298,1096,386,1106,376,123,142,134,131,132,146,135,135,155,129,120,34.310810810810814,202103
목공동로점,1180,949,231,862,318,877,303,118,119,111,90,112,113,100,99,108,96,114,46.20231822971549,202103
못골로점,1117,905,212,793,324,831,286,95,106,114,105,100,96,89,109,103,100,100,34.665193370165746,202103
무교로2점,1579,1271,308,1174,405,1172,407,148,142,158,134,143,145,144,135,143,118,169,34.61290322580645,202103
무교로점,882,716,166,648,234,655,227,80,89,80,74,85,70,84,88,85,82,65,34.26815642458101,202103
문예회관길점,1220,1011,209,912,308,904,316,132,90,120,105,116,113,101,94,115,102,132,20.12166172106825,202103
민락수변로점,1301,1056,245,974,327,966,335,137,113,101,118,110,129,121,119,119,123,111,34.390151515151516,202103
방죽로점,1254,1023,231,930,324,929,325,136,116,113,100,109,99,111,119,119,121,111,35.13782991202346,202103
배재로점,1526,1226,300,1122,404,1132,394,124,161,129,139,141,141,123,146,138,151,133,33.84747145187602,202103
법원로2점,1339,1092,247,1026,313,991,348,132,124,124,109,114,113,125,136,127,126,109,34.80128205128205,202103
법원로점,2295,1851,444,1712,583,1696,599,193,224,201,192,216,212,210,217,213,211,206,34.79308481901675,202103
보문로2점,1094,906,188,821,273,811,283,107,102,102,86,106,87,98,80,105,106,115,34.18653421633554,202103
보문로점,1187,967,220,866,321,877,310,88,118,82,137,102,126,93,122,92,109,118,34.55015511892451,202103
복수서로점,917,768,149,668,249,682,235,80,94,86,83,77,77,80,100,89,68,83,33.84375,202103
봉선로점,1180,980,200,881,299,874,306,115,103,85,111,131,111,107,90,108,103,116,34.001020408163264,202103
봉화산로2점,994,810,184,732,262,738,256,95,111,105,78,75,97,77,93,88,86,89,34.714814814814815,202103
봉화산로점,813,661,152,574,239,607,206,89,72,74,66,63,84,78,69,62,80,76,34.8714069591528,202103
부흥로점,1367,1122,245,989,378,1015,352,143,124,113,121,134,119,146,120,117,116,114,34.93048128342246,202103
북유성대로점,1303,1055,248,965,338,964,339,104,140,112,94,120,112,119,117,129,133,123,34.94691943127962,202103
분포로점,1549,1271,278,1133,416,1148,401,153,143,142,146,133,128,143,144,120,145,152,34.86309992132179,202103
비아로점,1548,1263,285,1167,381,1148,400,136,135,146,138,133,146,146,144,147,130,147,34.430720506730005,202103
사우중로점,1640,1361,279,1215,425,1217,423,127,155,171,134,151,145,131,160,159,154,153,34.164584864070534,202103
사직로2점,1027,853,174,772,255,759,268,94,101,77,110,95,93,70,103,86,89,109,35.225087924970694,202103
사직로점,2350,1877,473,1762,588,1748,602,229,214,204,202,228,224,224,202,198,222,203,34.75226425146511,202103
삼봉로2점,1361,1128,233,1017,344,1009,352,110,143,140,121,129,99,134,123,122,128,112,34.25443262411348,202103
삼봉로점,1035,861,174,787,248,769,266,93,111,102,98,80,89,90,112,99,82,79,34.89430894308943,202103
삼일대로2점,1002,808,194,713,289,742,260,76,83,84,86,100,90,79,100,91,121,92,34.290841584158414,202103
삼일대로점,1215,970,245,878,337,903,312,124,113,103,108,117,108,100,119,122,106,95,34.67113402061856,202103
상무공원로점,1428,1173,255,1043,385,1062,366,123,117,141,118,121,152,121,129,144,128,134,34.9462915601023,202103
상무대로점,1126,927,199,831,295,833,293,93,108,108,113,108,103,113,94,93,96,97,34.5091693635383,202103
상무번영로점,904,714,190,644,260,671,233,79,84,77,84,80,91,68,93,84,91,73,46.45378151260504,202103
서남로점,1117,910,207,810,307,827,290,115,106,116,98,85,97,100,104,93,117,86,34.04945054945055,202103
서소문로2점,1038,857,181,764,274,770,268,89,97,100,91,108,92,91,76,101,103,90,34.50175029171528,202103
서소문로점,1275,1036,239,915,360,951,324,115,117,115,127,104,123,113,113,126,117,105,34.81467181467181,202103
서초중앙로2점,1252,1021,231,947,305,926,326,119,102,123,109,118,126,108,109,105,120,113,34.43388834476004,202103
서초중앙로3점,1092,876,216,816,276,809,283,92,102,95,93,93,103,85,110,86,112,121,33.763698630136986,202103
서초중앙로점,1150,942,208,864,286,851,299,98,112,97,121,104,106,108,100,110,95,99,34.181528662420384,202103
서하로점,1551,1268,283,1142,409,1152,399,164,143,136,128,121,149,142,149,152,134,133,35.30520504731861,202103
석봉로점,849,685,164,643,206,628,221,85,77,81,74,75,67,72,87,65,87,79,33.7051094890511,202103
성남대로점,1544,1247,297,1144,400,1146,398,147,142,138,150,144,123,145,148,122,153,132,34.662389735364876,202103
성내로2점,1311,1059,252,918,393,971,340,123,141,119,113,118,133,134,96,102,131,101,35.169027384324835,202103
성내로점,974,798,176,734,240,723,251,92,81,86,90,107,80,85,85,96,89,83,46.69298245614035,202103
성산동2점,1371,1111,260,1008,363,1016,355,115,126,122,114,107,111,132,132,127,141,144,34.85418541854185,202103
성산동점,1030,838,192,776,254,763,267,99,84,94,100,98,76,93,102,98,93,93,20.35799522673031,202103
세종대로2점,1067,862,205,783,284,793,274,99,117,96,87,95,92,90,113,86,101,91,34.96519721577726,202103
세종대로점,1185,955,230,861,324,877,308,104,100,109,108,113,101,103,111,108,118,110,35.4565445026178,202103
세종로점,1184,954,230,864,320,877,307,104,101,105,113,109,104,110,109,114,107,108,34.706498951781974,202103
송정공원로점,912,761,151,681,231,675,237,75,75,90,91,85,87,99,78,82,75,75,34.303547963206306,202103
송정해변로점,1576,1301,275,1145,431,1168,408,164,144,139,148,150,130,141,130,146,128,156,20.047655649500385,202103
시흥대로2점,1002,830,172,722,280,743,259,93,102,90,91,94,94,77,85,89,93,94,34.04096385542169,202103
시흥대로점,1255,1024,231,919,336,932,323,121,119,126,114,130,107,117,120,95,84,122,34.2490234375,202103
신갈마로점,1188,981,207,860,328,881,307,101,102,122,104,76,110,126,118,87,128,114,34.80428134556575,202103
신일동로점,1359,1075,284,982,377,1006,353,109,123,122,105,114,117,139,121,125,139,145,33.87720930232558,202103
신일서로점,1273,1035,238,962,311,944,329,110,114,116,111,119,107,121,123,124,109,119,34.265700483091784,202103
안양천로2점,1156,922,234,842,314,858,298,88,101,92,102,103,98,111,106,129,100,126,33.97396963123644,202103
안양천로점,1215,1004,211,918,297,902,313,106,114,101,122,94,106,110,125,127,104,106,34.47609561752988,202103
양재2점,1307,1062,245,970,337,968,339,119,104,118,127,135,112,107,122,112,118,133,33.68173258003767,202103
양재점,1209,978,231,899,310,898,311,98,127,136,104,98,111,112,96,104,115,108,34.923312883435585,202103
어등대로점,1220,979,241,908,312,905,315,104,125,118,99,109,100,113,117,103,107,125,34.244126659856995,202103
엑스포로점,1120,913,207,829,291,831,289,91,99,112,94,101,91,97,113,122,97,103,34.54216867469879,202103
연제로점,1432,1158,274,1063,369,1061,371,154,121,143,124,142,105,143,110,130,125,135,34.22711571675302,202103
연희로2점,1425,1166,259,1075,350,1059,366,145,133,148,140,119,137,123,114,126,130,110,34.187821612349914,202103
연희로점,1096,881,215,783,313,814,282,99,95,107,92,99,101,92,96,109,101,105,33.29738933030647,202103
영통구점,1096,910,186,819,277,811,285,102,101,103,79,108,86,99,104,106,113,95,34.550549450549454,202103
예술길점,1183,966,217,878,305,879,304,92,112,110,122,92,116,112,109,89,113,116,34.26915113871635,202103
온천천로점,1577,1283,294,1161,416,1167,410,122,140,145,156,137,135,151,144,154,149,144,34.372564302416215,202103
올림픽로2점,1397,1153,244,1005,392,1035,362,134,115,126,111,135,127,137,135,130,122,125,20.550737207285344,202103
올림픽로점,1006,813,193,730,276,748,258,76,95,98,101,102,77,102,97,102,76,80,34.742927429274296,202103
용대로점,1065,875,190,809,256,788,277,112,83,83,94,108,100,94,98,88,100,105,35.331428571428575,202103
용아로점,1361,1107,254,1027,334,1007,354,126,117,128,137,127,124,117,124,131,104,126,34.35682023486901,202103
용운동점,876,701,175,687,189,648,228,77,86,63,98,82,82,91,66,78,85,68,34.93723252496434,202103
우치로점,1157,908,249,838,319,859,298,93,100,111,105,101,102,106,122,106,104,107,47.82378854625551,202103
월계로2점,1035,829,206,748,287,768,267,91,93,83,96,81,86,92,104,100,102,107,35.248492159227986,202103
월계로점,1243,1012,231,909,334,925,318,111,101,100,116,126,118,118,112,115,114,112,20.371541501976285,202103
월드컵대로2점,905,748,157,666,239,675,230,88,67,80,81,90,70,85,73,92,89,90,35.37967914438503,202103
월드컵대로점,1152,944,208,848,304,853,299,93,93,98,90,123,100,123,119,111,99,103,34.20550847457627,202103
월드컵로2점,1429,1176,253,1072,357,1064,365,143,122,149,133,121,121,124,122,138,132,124,34.22534013605442,202103
월드컵로점,945,798,147,724,221,701,244,89,84,80,84,84,90,94,78,84,87,91,34.689223057644114,202103
은평로2점,878,719,159,639,239,653,225,83,71,81,84,81,83,96,71,77,77,74,34.157162726008345,202103
은평로점,1250,1018,232,889,361,925,325,113,97,104,112,137,97,98,114,129,128,121,34.54322200392927,202103
일산동구점,1152,953,199,832,320,854,298,117,93,108,91,142,111,88,119,87,88,108,34.50472193074501,202103
자양로2점,1095,886,209,777,318,814,281,97,103,91,84,86,101,119,105,96,114,99,34.97404063205418,202103
자양로점,1184,966,218,849,335,880,304,102,113,119,109,124,97,109,99,100,111,101,34.992753623188406,202103
장대로점,1247,1017,230,903,344,925,322,110,119,134,103,113,108,105,105,119,108,123,34.534906588003935,202103
장동로점,1001,832,169,750,251,740,261,97,99,87,92,101,84,85,90,102,73,91,34.48317307692308,202103
장승배기로2점,1187,965,222,870,317,880,307,94,109,123,120,111,107,107,106,94,113,103,34.46321243523316,202103
장승배기로점,1161,964,197,877,284,863,298,100,108,92,100,105,128,102,108,100,115,103,20.448132780082986,202103
재반로점,1244,1013,231,936,308,921,323,105,111,120,115,120,135,114,89,120,116,99,34.79763079960513,202103
절영로점,1492,1224,268,1089,403,1108,384,164,131,121,137,150,129,132,139,127,128,134,34.83578431372549,202103
절재로점,1389,1117,272,1039,350,1027,362,121,110,143,136,129,135,111,125,118,116,145,34.88540734109221,202103
제중로점,1182,967,215,867,315,875,307,104,99,98,119,117,113,102,122,107,94,107,35.196483971044465,202103
조치원점,1186,958,228,872,314,878,308,100,107,121,106,113,108,126,76,104,112,113,34.234864300626306,202103
종로2점,1544,1254,290,1135,409,1142,402,136,132,146,148,117,148,159,134,146,135,143,34.35087719298246,202103
종로점,1095,862,233,794,301,813,282,95,114,115,106,83,98,99,95,99,85,106,35.13341067285383,202103
준법로점,1155,953,202,858,297,859,296,105,111,111,120,87,109,98,102,107,103,102,34.66211962224554,202103
중구로점,1483,1192,291,1082,401,1100,383,136,148,139,131,130,129,133,136,128,139,134,34.06208053691275,202103
중동2로점,727,600,127,548,179,543,184,78,61,50,75,60,75,66,60,74,76,52,35.265,202103
중앙대로2점,1397,1154,243,1049,348,1039,358,119,116,120,123,116,145,127,113,144,138,136,34.37001733102253,202103
중앙대로점,2249,1834,415,1619,630,1665,584,195,201,226,206,173,191,195,219,206,214,223,34.353871319520174,202103
증심사길점,1309,1069,240,969,340,973,336,136,120,125,121,121,101,119,121,121,116,108,34.32553788587465,202103
창경궁로2점,1460,1206,254,1091,369,1085,375,124,120,133,121,150,125,138,125,134,159,131,34.072968490878935,202103
창경궁로점,1280,1039,241,1008,272,950,330,120,113,117,108,112,112,123,119,127,111,118,33.94995187680462,202103
처인구점,1034,841,193,764,270,769,265,82,107,104,100,97,89,81,91,100,95,88,34.39833531510107,202103
천호대로2점,1567,1290,277,1142,425,1162,405,139,158,146,143,113,141,135,152,139,146,155,34.87829457364341,202103
천호대로점,1008,820,188,742,266,749,259,93,97,108,84,86,87,86,88,81,109,89,34.989024390243905,202103
첨단과기로점,1345,1102,243,993,352,999,346,124,141,104,125,114,138,104,139,105,126,125,35.76950998185118,202103
청계청로2점,1376,1131,245,1010,366,1022,354,132,125,124,127,135,142,114,134,111,120,112,33.9867374005305,202103
청계청로점,913,736,177,687,226,678,235,84,73,76,87,76,95,82,98,83,85,74,34.75135869565217,202103
청사포로점,1279,1054,225,950,329,950,329,131,122,113,124,128,107,101,107,111,114,121,19.944022770398483,202103
태종로점,1187,960,227,860,327,878,309,134,101,114,109,108,112,112,110,93,85,109,35.1,202103
필문대로점,1186,970,216,869,317,880,306,122,95,102,109,110,116,107,112,107,110,96,34.009278350515466,202103
하남산단점,1031,835,196,768,263,766,265,88,77,94,80,103,94,95,112,85,105,98,35.288622754491016,202103
하리해안길점,1151,950,201,868,283,854,297,121,111,106,99,109,92,109,110,115,100,79,34.94421052631579,202103
하신번영로점,1514,1239,275,1093,421,1121,393,144,139,121,140,157,149,132,139,138,127,128,34.87974172719935,202103
하신중앙로점,1248,1014,234,934,314,929,319,124,112,112,114,120,101,130,111,99,113,112,35.218934911242606,202103
학감대로점,1427,1176,251,1058,369,1060,367,130,117,139,130,125,136,147,113,128,120,142,34.881802721088434,202103
학동로2점,1462,1209,253,1080,382,1082,380,152,123,123,136,129,137,136,133,124,140,129,34.484698097601324,202103
학동로점,1429,1161,268,1037,392,1058,371,136,120,134,108,141,118,141,136,125,143,127,34.883720930232556,202103
한남로점,1037,859,178,765,272,769,268,113,76,109,73,103,92,98,94,95,95,89,34.31082654249127,202103
한누리대로점,1307,1059,248,979,328,971,336,113,112,118,113,109,128,126,127,124,107,130,34.80925401322002,202103
한밭대로점,1103,868,235,804,299,819,284,94,96,104,116,99,99,90,108,94,102,101,49.345622119815665,202103
해안새벽시장길점,1256,1029,227,929,327,932,324,112,121,113,116,108,116,121,102,111,115,121,34.91059280855199,202103
해운대로점,1435,1169,266,1081,354,1064,371,138,127,123,147,140,115,124,126,140,127,128,33.786142001710864,202103
해운대해변로점,1035,853,182,764,271,769,266,91,94,80,102,110,89,89,94,100,99,87,21.0820633059789,202103
화곡로2점,1218,971,247,897,321,901,317,109,114,131,109,110,89,106,106,111,117,116,34.7167868177137,202103
화곡로점,1096,896,200,837,259,814,282,112,102,101,93,98,91,110,93,95,106,95,34.171875,202103
화중로점,1187,953,234,869,318,882,305,102,123,90,140,107,94,116,107,107,106,95,34.453305351521514,202103
효덕로점,1331,1097,234,1018,313,990,341,129,128,120,105,124,105,112,116,133,137,122,34.67730173199635,202103
효원로점,814,661,153,594,220,607,207,82,80,75,65,57,72,85,78,61,75,84,34.998487140695914,202103
